Кол-во элементов;Кол-во элементов в ^ 2;Кол-во перестановок;Кол-во сравнений;Сумма сравнений и перестановок;Кол-во итераций;Время на сортировку;Тип сортировки
0;0;0;2;2;0;0.000002;quickSort
100;10000;63;669;732;543;0.000006;quickSort
200;40000;127;1534;1661;1280;0.000012;quickSort
300;90000;172;2414;2586;2070;0.000017;quickSort
400;160000;255;3463;3718;2953;0.000022;quickSort
500;250000;255;4263;4518;3753;0.000068;quickSort
600;360000;344;5419;5763;4731;0.000032;quickSort
700;490000;444;6619;7063;5731;0.000040;quickSort
800;640000;511;7720;8231;6698;0.000046;quickSort
900;810000;511;8620;9131;7598;0.000072;quickSort
1000;1000000;511;9520;10031;8498;0.000051;quickSort
1100;1210000;588;10728;11316;9552;0.000054;quickSort
1200;1440000;688;12028;12716;10652;0.000134;quickSort
1300;1690000;788;13328;14116;11752;0.000075;quickSort
1400;1960000;888;14628;15516;12852;0.000074;quickSort
1500;2250000;988;15928;16916;13952;0.000183;quickSort
1600;2560000;1023;17033;18056;14987;0.000098;quickSort
1700;2890000;1023;18033;19056;15987;0.000104;quickSort
1800;3240000;1023;19033;20056;16987;0.000102;quickSort
1900;3610000;1023;20033;21056;17987;0.000097;quickSort
2000;4000000;1023;21033;22056;18987;0.000101;quickSort
2100;4410000;1076;22245;23321;20093;0.000113;quickSort
2200;4840000;1176;23645;24821;21293;0.000130;quickSort
2300;5290000;1276;25045;26321;22493;0.000120;quickSort
2400;5760000;1376;26445;27821;23693;0.000129;quickSort
2500;6250000;1476;27845;29321;24893;0.000138;quickSort
2600;6760000;1576;29245;30821;26093;0.000146;quickSort
2700;7290000;1676;30645;32321;27293;0.000150;quickSort
2800;7840000;1776;32045;33821;28493;0.000181;quickSort
2900;8410000;1876;33445;35321;29693;0.000164;quickSort
3000;9000000;1976;34845;36821;30893;0.000171;quickSort
3100;9610000;2047;36158;38205;32064;0.000179;quickSort
3200;10240000;2047;37258;39305;33164;0.000185;quickSort
3300;10890000;2047;38358;40405;34264;0.000189;quickSort
3400;11560000;2047;39458;41505;35364;0.000220;quickSort
3500;12250000;2047;40558;42605;36464;0.000196;quickSort
3600;12960000;2047;41658;43705;37564;0.000448;quickSort
3700;13690000;2047;42758;44805;38664;0.000202;quickSort
3800;14440000;2047;43858;45905;39764;0.000210;quickSort
3900;15210000;2047;44958;47005;40864;0.000210;quickSort
4000;16000000;2047;46058;48105;41964;0.000572;quickSort
4100;16810000;2052;47178;49230;43074;0.000222;quickSort
4200;17640000;2152;48678;50830;44374;0.000228;quickSort
4300;18490000;2252;50178;52430;45674;0.000235;quickSort
4400;19360000;2352;51678;54030;46974;0.000549;quickSort
4500;20250000;2452;53178;55630;48274;0.000620;quickSort
4600;21160000;2552;54678;57230;49574;0.000585;quickSort
4700;22090000;2652;56178;58830;50874;0.000299;quickSort
4800;23040000;2752;57678;60430;52174;0.000275;quickSort
4900;24010000;2852;59178;62030;53474;0.000281;quickSort
5000;25000000;2952;60678;63630;54774;0.000653;quickSort
5100;26010000;3052;62178;65230;56074;0.000632;quickSort
5200;27040000;3152;63678;66830;57374;0.000718;quickSort
5300;28090000;3252;65178;68430;58674;0.000320;quickSort
5400;29160000;3352;66678;70030;59974;0.000324;quickSort
5500;30250000;3452;68178;71630;61274;0.001065;quickSort
5600;31360000;3552;69678;73230;62574;0.000364;quickSort
5700;32490000;3652;71178;74830;63874;0.000394;quickSort
5800;33640000;3752;72678;76430;65174;0.000360;quickSort
5900;34810000;3852;74178;78030;66474;0.000362;quickSort
6000;36000000;3952;75678;79630;67774;0.000417;quickSort
6100;37210000;4052;77178;81230;69074;0.001067;quickSort
6200;38440000;4095;78507;82602;70317;0.000440;quickSort
6300;39690000;4095;79707;83802;71517;0.000416;quickSort
6400;40960000;4095;80907;85002;72717;0.000454;quickSort
6500;42250000;4095;82107;86202;73917;0.000427;quickSort
6600;43560000;4095;83307;87402;75117;0.000403;quickSort
6700;44890000;4095;84507;88602;76317;0.000461;quickSort
6800;46240000;4095;85707;89802;77517;0.000468;quickSort
6900;47610000;4095;86907;91002;78717;0.000414;quickSort
7000;49000000;4095;88107;92202;79917;0.000417;quickSort
7100;50410000;4095;89307;93402;81117;0.000425;quickSort
7200;51840000;4095;90507;94602;82317;0.000514;quickSort
7300;53290000;4095;91707;95802;83517;0.000487;quickSort
7400;54760000;4095;92907;97002;84717;0.000432;quickSort
7500;56250000;4095;94107;98202;85917;0.000443;quickSort
7600;57760000;4095;95307;99402;87117;0.000439;quickSort
7700;59290000;4095;96507;100602;88317;0.000449;quickSort
7800;60840000;4095;97707;101802;89517;0.000449;quickSort
7900;62410000;4095;98907;103002;90717;0.000988;quickSort
8000;64000000;4095;100107;104202;91917;0.000467;quickSort
8100;65610000;4095;101307;105402;93117;0.000466;quickSort
8200;67240000;4104;102543;106647;94335;0.000487;quickSort
8300;68890000;4204;104143;108347;95735;0.000491;quickSort
8400;70560000;4304;105743;110047;97135;0.000574;quickSort
8500;72250000;4404;107343;111747;98535;0.001052;quickSort
8600;73960000;4504;108943;113447;99935;0.000566;quickSort
8700;75690000;4604;110543;115147;101335;0.000524;quickSort
8800;77440000;4704;112143;116847;102735;0.000520;quickSort
8900;79210000;4804;113743;118547;104135;0.000579;quickSort
9000;81000000;4904;115343;120247;105535;0.000564;quickSort
9100;82810000;5004;116943;121947;106935;0.000551;quickSort
9200;84640000;5104;118543;123647;108335;0.000581;quickSort
9300;86490000;5204;120143;125347;109735;0.000567;quickSort
9400;88360000;5304;121743;127047;111135;0.000593;quickSort
9500;90250000;5404;123343;128747;112535;0.000568;quickSort
9600;92160000;5504;124943;130447;113935;0.000583;quickSort
9700;94090000;5604;126543;132147;115335;0.001131;quickSort
9800;96040000;5704;128143;133847;116735;0.000607;quickSort
9900;98010000;5804;129743;135547;118135;0.000696;quickSort
10000;100000000;5904;131343;137247;119535;0.000771;quickSort
10100;102010000;6004;132943;138947;120935;0.000677;quickSort
10200;104040000;6104;134543;140647;122335;0.000697;quickSort
10300;106090000;6204;136143;142347;123735;0.000624;quickSort
10400;108160000;6304;137743;144047;125135;0.000637;quickSort
10500;110250000;6404;139343;145747;126535;0.000668;quickSort
10600;112360000;6504;140943;147447;127935;0.000670;quickSort
10700;114490000;6604;142543;149147;129335;0.000797;quickSort
10800;116640000;6704;144143;150847;130735;0.000693;quickSort
10900;118810000;6804;145743;152547;132135;0.000727;quickSort
11000;121000000;6904;147343;154247;133535;0.000715;quickSort
11100;123210000;7004;148943;155947;134935;0.000738;quickSort
11200;125440000;7104;150543;157647;136335;0.000732;quickSort
11300;127690000;7204;152143;159347;137735;0.001373;quickSort
11400;129960000;7304;153743;161047;139135;0.000727;quickSort
11500;132250000;7404;155343;162747;140535;0.000748;quickSort
11600;134560000;7504;156943;164447;141935;0.000743;quickSort
11700;136890000;7604;158543;166147;143335;0.000751;quickSort
11800;139240000;7704;160143;167847;144735;0.000781;quickSort
11900;141610000;7804;161743;169547;146135;0.000777;quickSort
12000;144000000;7904;163343;171247;147535;0.000772;quickSort
12100;146410000;8004;164943;172947;148935;0.001411;quickSort
12200;148840000;8104;166543;174647;150335;0.000793;quickSort
12300;151290000;8191;168104;176295;151722;0.000993;quickSort
12400;153760000;8191;169404;177595;153022;0.000808;quickSort
12500;156250000;8191;170704;178895;154322;0.000826;quickSort
12600;158760000;8191;172004;180195;155622;0.000821;quickSort
12700;161290000;8191;173304;181495;156922;0.000861;quickSort
12800;163840000;8191;174604;182795;158222;0.000843;quickSort
12900;166410000;8191;175904;184095;159522;0.000847;quickSort
13000;169000000;8191;177204;185395;160822;0.001646;quickSort
13100;171610000;8191;178504;186695;162122;0.000850;quickSort
13200;174240000;8191;179804;187995;163422;0.000898;quickSort
13300;176890000;8191;181104;189295;164722;0.000868;quickSort
13400;179560000;8191;182404;190595;166022;0.000919;quickSort
13500;182250000;8191;183704;191895;167322;0.000958;quickSort
13600;184960000;8191;185004;193195;168622;0.000897;quickSort
13700;187690000;8191;186304;194495;169922;0.001347;quickSort
13800;190440000;8191;187604;195795;171222;0.000883;quickSort
13900;193210000;8191;188904;197095;172522;0.000904;quickSort
14000;196000000;8191;190204;198395;173822;0.000903;quickSort
14100;198810000;8191;191504;199695;175122;0.000893;quickSort
14200;201640000;8191;192804;200995;176422;0.000916;quickSort
14300;204490000;8191;194104;202295;177722;0.000911;quickSort
14400;207360000;8191;195404;203595;179022;0.000903;quickSort
14500;210250000;8191;196704;204895;180322;0.000922;quickSort
14600;213160000;8191;198004;206195;181622;0.000924;quickSort
14700;216090000;8191;199304;207495;182922;0.000999;quickSort
14800;219040000;8191;200604;208795;184222;0.000927;quickSort
14900;222010000;8191;201904;210095;185522;0.001513;quickSort
15000;225000000;8191;203204;211395;186822;0.000933;quickSort
15100;228010000;8191;204504;212695;188122;0.000951;quickSort
15200;231040000;8191;205804;213995;189422;0.001504;quickSort
15300;234090000;8191;207104;215295;190722;0.001170;quickSort
15400;237160000;8191;208404;216595;192022;0.000968;quickSort
15500;240250000;8191;209704;217895;193322;0.001646;quickSort
15600;243360000;8191;211004;219195;194622;0.000967;quickSort
15700;246490000;8191;212304;220495;195922;0.000968;quickSort
15800;249640000;8191;213604;221795;197222;0.000968;quickSort
15900;252810000;8191;214904;223095;198522;0.001481;quickSort
16000;256000000;8191;216204;224395;199822;0.000989;quickSort
16100;259210000;8191;217504;225695;201122;0.001489;quickSort
16200;262440000;8191;218804;226995;202422;0.000990;quickSort
16300;265690000;8191;220104;228295;203722;0.001134;quickSort
16400;268960000;8208;221472;229680;205056;0.001005;quickSort
16500;272250000;8308;223172;231480;206556;0.001263;quickSort
16600;275560000;8408;224872;233280;208056;0.001174;quickSort
16700;278890000;8508;226572;235080;209556;0.001032;quickSort
16800;282240000;8608;228272;236880;211056;0.001134;quickSort
16900;285610000;8708;229972;238680;212556;0.001050;quickSort
17000;289000000;8808;231672;240480;214056;0.001157;quickSort
17100;292410000;8908;233372;242280;215556;0.001244;quickSort
17200;295840000;9008;235072;244080;217056;0.001146;quickSort
17300;299290000;9108;236772;245880;218556;0.001088;quickSort
17400;302760000;9208;238472;247680;220056;0.001091;quickSort
17500;306250000;9308;240172;249480;221556;0.001127;quickSort
17600;309760000;9408;241872;251280;223056;0.001295;quickSort
17700;313290000;9508;243572;253080;224556;0.001249;quickSort
17800;316840000;9608;245272;254880;226056;0.001388;quickSort
17900;320410000;9708;246972;256680;227556;0.001302;quickSort
18000;324000000;9808;248672;258480;229056;0.001265;quickSort
18100;327610000;9908;250372;260280;230556;0.001367;quickSort
18200;331240000;10008;252072;262080;232056;0.001513;quickSort
18300;334890000;10108;253772;263880;233556;0.001725;quickSort
18400;338560000;10208;255472;265680;235056;0.001422;quickSort
18500;342250000;10308;257172;267480;236556;0.001379;quickSort
18600;345960000;10408;258872;269280;238056;0.001273;quickSort
18700;349690000;10508;260572;271080;239556;0.001436;quickSort
18800;353440000;10608;262272;272880;241056;0.001595;quickSort
18900;357210000;10708;263972;274680;242556;0.001212;quickSort
19000;361000000;10808;265672;276480;244056;0.001252;quickSort
19100;364810000;10908;267372;278280;245556;0.001251;quickSort
19200;368640000;11008;269072;280080;247056;0.001430;quickSort
19300;372490000;11108;270772;281880;248556;0.001252;quickSort
19400;376360000;11208;272472;283680;250056;0.001383;quickSort
19500;380250000;11308;274172;285480;251556;0.001283;quickSort
19600;384160000;11408;275872;287280;253056;0.001272;quickSort
19700;388090000;11508;277572;289080;254556;0.001473;quickSort
19800;392040000;11608;279272;290880;256056;0.001294;quickSort
19900;396010000;11708;280972;292680;257556;0.001309;quickSort
20000;400000000;11808;282672;294480;259056;0.001304;quickSort
20100;404010000;11908;284372;296280;260556;0.001317;quickSort
20200;408040000;12008;286072;298080;262056;0.001316;quickSort
20300;412090000;12108;287772;299880;263556;0.001339;quickSort
20400;416160000;12208;289472;301680;265056;0.001360;quickSort
20500;420250000;12308;291172;303480;266556;0.001573;quickSort
20600;424360000;12408;292872;305280;268056;0.001579;quickSort
20700;428490000;12508;294572;307080;269556;0.001375;quickSort
20800;432640000;12608;296272;308880;271056;0.001378;quickSort
20900;436810000;12708;297972;310680;272556;0.001407;quickSort
21000;441000000;12808;299672;312480;274056;0.001400;quickSort
21100;445210000;12908;301372;314280;275556;0.001411;quickSort
21200;449440000;13008;303072;316080;277056;0.001416;quickSort
21300;453690000;13108;304772;317880;278556;0.001629;quickSort
21400;457960000;13208;306472;319680;280056;0.001463;quickSort
21500;462250000;13308;308172;321480;281556;0.001445;quickSort
21600;466560000;13408;309872;323280;283056;0.001459;quickSort
21700;470890000;13508;311572;325080;284556;0.001576;quickSort
21800;475240000;13608;313272;326880;286056;0.001488;quickSort
21900;479610000;13708;314972;328680;287556;0.001485;quickSort
22000;484000000;13808;316672;330480;289056;0.001494;quickSort
22100;488410000;13908;318372;332280;290556;0.001495;quickSort
22200;492840000;14008;320072;334080;292056;0.001509;quickSort
22300;497290000;14108;321772;335880;293556;0.001977;quickSort
22400;501760000;14208;323472;337680;295056;0.001612;quickSort
22500;506250000;14308;325172;339480;296556;0.001788;quickSort
22600;510760000;14408;326872;341280;298056;0.001745;quickSort
22700;515290000;14508;328572;343080;299556;0.001612;quickSort
22800;519840000;14608;330272;344880;301056;0.001585;quickSort
22900;524410000;14708;331972;346680;302556;0.001765;quickSort
23000;529000000;14808;333672;348480;304056;0.001662;quickSort
23100;533610000;14908;335372;350280;305556;0.001687;quickSort
23200;538240000;15008;337072;352080;307056;0.001626;quickSort
23300;542890000;15108;338772;353880;308556;0.001606;quickSort
23400;547560000;15208;340472;355680;310056;0.001621;quickSort
23500;552250000;15308;342172;357480;311556;0.001673;quickSort
23600;556960000;15408;343872;359280;313056;0.001693;quickSort
23700;561690000;15508;345572;361080;314556;0.001754;quickSort
23800;566440000;15608;347272;362880;316056;0.001630;quickSort
23900;571210000;15708;348972;364680;317556;0.001638;quickSort
24000;576000000;15808;350672;366480;319056;0.001645;quickSort
24100;580810000;15908;352372;368280;320556;0.001672;quickSort
24200;585640000;16008;354072;370080;322056;0.001710;quickSort
24300;590490000;16108;355772;371880;323556;0.001701;quickSort
24400;595360000;16208;357472;373680;325056;0.001731;quickSort
24500;600250000;16308;359172;375480;326556;0.001773;quickSort
24600;605160000;16383;360797;377180;328031;0.001720;quickSort
24700;610090000;16383;362197;378580;329431;0.001723;quickSort
24800;615040000;16383;363597;379980;330831;0.001797;quickSort
24900;620010000;16383;364997;381380;332231;0.001723;quickSort
25000;625000000;16383;366397;382780;333631;0.001726;quickSort
25100;630010000;16383;367797;384180;335031;0.001738;quickSort
25200;635040000;16383;369197;385580;336431;0.001747;quickSort
25300;640090000;16383;370597;386980;337831;0.001750;quickSort
25400;645160000;16383;371997;388380;339231;0.002332;quickSort
25500;650250000;16383;373397;389780;340631;0.002338;quickSort
25600;655360000;16383;374797;391180;342031;0.001784;quickSort
25700;660490000;16383;376197;392580;343431;0.002368;quickSort
25800;665640000;16383;377597;393980;344831;0.001783;quickSort
25900;670810000;16383;378997;395380;346231;0.002092;quickSort
26000;676000000;16383;380397;396780;347631;0.002355;quickSort
27500;756250000;16383;401397;417780;368631;0.001825;quickSort
27600;761760000;16383;402797;419180;370031;0.001836;quickSort
27700;767290000;16383;404197;420580;371431;0.001882;quickSort
27800;772840000;16383;405597;421980;372831;0.002500;quickSort
27900;778410000;16383;406997;423380;374231;0.001882;quickSort
28000;784000000;16383;408397;424780;375631;0.001887;quickSort
28100;789610000;16383;409797;426180;377031;0.002026;quickSort
28200;795240000;16383;411197;427580;378431;0.002016;quickSort
28300;800890000;16383;412597;428980;379831;0.002465;quickSort
28400;806560000;16383;413997;430380;381231;0.001900;quickSort
28500;812250000;16383;415397;431780;382631;0.001857;quickSort
28600;817960000;16383;416797;433180;384031;0.001902;quickSort
28700;823690000;16383;418197;434580;385431;0.001912;quickSort
28800;829440000;16383;419597;435980;386831;0.001909;quickSort
28900;835210000;16383;420997;437380;388231;0.001921;quickSort
29000;841000000;16383;422397;438780;389631;0.001932;quickSort
29100;846810000;16383;423797;440180;391031;0.001930;quickSort
29200;852640000;16383;425197;441580;392431;0.001940;quickSort
29300;858490000;16383;426597;442980;393831;0.001938;quickSort
29400;864360000;16383;427997;444380;395231;0.001987;quickSort
29500;870250000;16383;429397;445780;396631;0.001959;quickSort
29600;876160000;16383;430797;447180;398031;0.002425;quickSort
29700;882090000;16383;432197;448580;399431;0.002024;quickSort
29800;888040000;16383;433597;449980;400831;0.001977;quickSort
29900;894010000;16383;434997;451380;402231;0.002501;quickSort
30000;900000000;16383;436397;452780;403631;0.001984;quickSort
30100;906010000;16383;437797;454180;405031;0.001985;quickSort
30200;912040000;16383;439197;455580;406431;0.001993;quickSort
30300;918090000;16383;440597;456980;407831;0.002624;quickSort
30400;924160000;16383;441997;458380;409231;0.002021;quickSort
30500;930250000;16383;443397;459780;410631;0.002006;quickSort
30600;936360000;16383;444797;461180;412031;0.002011;quickSort
30700;942490000;16383;446197;462580;413431;0.002568;quickSort
30800;948640000;16383;447597;463980;414831;0.002028;quickSort
30900;954810000;16383;448997;465380;416231;0.002027;quickSort
31000;961000000;16383;450397;466780;417631;0.002035;quickSort
31100;967210000;16383;451797;468180;419031;0.002150;quickSort
31200;973440000;16383;453197;469580;420431;0.002234;quickSort
31300;979690000;16383;454597;470980;421831;0.002383;quickSort
31400;985960000;16383;455997;472380;423231;0.002054;quickSort
31500;992250000;16383;457397;473780;424631;0.002061;quickSort
31600;998560000;16383;458797;475180;426031;0.002396;quickSort
31700;1004890000;16383;460197;476580;427431;0.002076;quickSort
31800;1011240000;16383;461597;477980;428831;0.002542;quickSort
31900;1017610000;16383;462997;479380;430231;0.002089;quickSort
32000;1024000000;16383;464397;480780;431631;0.002090;quickSort
32100;1030410000;16383;465797;482180;433031;0.002090;quickSort
32200;1036840000;16383;467197;483580;434431;0.002983;quickSort
32300;1043290000;16383;468597;484980;435831;0.002113;quickSort
32400;1049760000;16383;469997;486380;437231;0.002181;quickSort
32500;1056250000;16383;471397;487780;438631;0.002108;quickSort
32600;1062760000;16383;472797;489180;440031;0.002124;quickSort
32700;1069290000;16383;474197;490580;441431;0.002123;quickSort
32800;1075840000;16416;475729;492145;442897;0.002116;quickSort
32900;1082410000;16516;477529;494045;444497;0.003183;quickSort
33000;1089000000;16616;479329;495945;446097;0.002283;quickSort
33100;1095610000;16716;481129;497845;447697;0.002192;quickSort
33200;1102240000;16816;482929;499745;449297;0.002168;quickSort
33300;1108890000;16916;484729;501645;450897;0.002208;quickSort
33400;1115560000;17016;486529;503545;452497;0.002200;quickSort
33500;1122250000;17116;488329;505445;454097;0.002459;quickSort
33600;1128960000;17216;490129;507345;455697;0.002233;quickSort
33700;1135690000;17316;491929;509245;457297;0.002296;quickSort
33800;1142440000;17416;493729;511145;458897;0.002241;quickSort
33900;1149210000;17516;495529;513045;460497;0.002272;quickSort
34000;1156000000;17616;497329;514945;462097;0.002804;quickSort
34100;1162810000;17716;499129;516845;463697;0.002280;quickSort
34200;1169640000;17816;500929;518745;465297;0.002321;quickSort
34300;1176490000;17916;502729;520645;466897;0.003269;quickSort
34400;1183360000;18016;504529;522545;468497;0.002291;quickSort
34500;1190250000;18116;506329;524445;470097;0.002343;quickSort
34600;1197160000;18216;508129;526345;471697;0.002306;quickSort
34700;1204090000;18316;509929;528245;473297;0.002324;quickSort
34800;1211040000;18416;511729;530145;474897;0.002343;quickSort
34900;1002257808;18516;513529;532045;476497;0.002334;quickSort
35000;1009247808;18616;515329;533945;478097;0.002843;quickSort
35100;1016257808;18716;517129;535845;479697;0.002678;quickSort
35200;1023287808;18816;518929;537745;481297;0.002391;quickSort
35300;1030337808;18916;520729;539645;482897;0.003101;quickSort
35400;1037407808;19016;522529;541545;484497;0.002380;quickSort
35500;1044497808;19116;524329;543445;486097;0.002421;quickSort
35600;1051607808;19216;526129;545345;487697;0.002546;quickSort
35700;1058737808;19316;527929;547245;489297;0.002725;quickSort
35800;1065887808;19416;529729;549145;490897;0.002406;quickSort
35900;1073057808;19516;531529;551045;492497;0.002416;quickSort
36000;1080247808;19616;533329;552945;494097;0.002804;quickSort
36100;1087457808;19716;535129;554845;495697;0.002435;quickSort
36200;1094687808;19816;536929;556745;497297;0.002436;quickSort
36300;1101937808;19916;538729;558645;498897;0.002444;quickSort
36400;1109207808;20016;540529;560545;500497;0.002469;quickSort
36500;1116497808;20116;542329;562445;502097;0.002958;quickSort
36600;1123807808;20216;544129;564345;503697;0.002495;quickSort
36700;1131137808;20316;545929;566245;505297;0.002868;quickSort
36800;1138487808;20416;547729;568145;506897;0.002866;quickSort
36900;1145857808;20516;549529;570045;508497;0.002539;quickSort
37000;1153247808;20616;551329;571945;510097;0.002505;quickSort
37100;1160657808;20716;553129;573845;511697;0.002537;quickSort
37200;1168087808;20816;554929;575745;513297;0.002739;quickSort
37300;1175537808;20916;556729;577645;514897;0.002771;quickSort
37400;1183007808;21016;558529;579545;516497;0.002556;quickSort
37500;1190497808;21116;560329;581445;518097;0.003053;quickSort
37600;1198007808;21216;562129;583345;519697;0.002696;quickSort
37700;1205537808;21316;563929;585245;521297;0.002643;quickSort
37800;1213087808;21416;565729;587145;522897;0.002574;quickSort
37900;1220657808;21516;567529;589045;524497;0.002602;quickSort
38000;1228247808;21616;569329;590945;526097;0.002602;quickSort
38100;1235857808;21716;571129;592845;527697;0.003006;quickSort
38200;1243487808;21816;572929;594745;529297;0.002626;quickSort
38300;1251137808;21916;574729;596645;530897;0.002981;quickSort
38400;1258807808;22016;576529;598545;532497;0.002625;quickSort
38500;1266497808;22116;578329;600445;534097;0.002813;quickSort
38600;1274207808;22216;580129;602345;535697;0.002645;quickSort
38700;1281937808;22316;581929;604245;537297;0.002671;quickSort
38800;1289687808;22416;583729;606145;538897;0.002591;quickSort
38900;1297457808;22516;585529;608045;540497;0.003235;quickSort
39000;1305247808;22616;587329;609945;542097;0.002684;quickSort
39100;1313057808;22716;589129;611845;543697;0.002698;quickSort
39200;1320887808;22816;590929;613745;545297;0.002725;quickSort
39300;1328737808;22916;592729;615645;546897;0.002681;quickSort
39400;1336607808;23016;594529;617545;548497;0.002717;quickSort
39500;1344497808;23116;596329;619445;550097;0.002912;quickSort
39600;1352407808;23216;598129;621345;551697;0.002757;quickSort
39700;1360337808;23316;599929;623245;553297;0.002923;quickSort
39800;1368287808;23416;601729;625145;554897;0.002746;quickSort
39900;1376257808;23516;603529;627045;556497;0.002782;quickSort
40000;1384247808;23616;605329;628945;558097;0.002799;quickSort
40100;1392257808;23716;607129;630845;559697;0.002821;quickSort
40200;1400287808;23816;608929;632745;561297;0.002791;quickSort
40300;1408337808;23916;610729;634645;562897;0.002912;quickSort
40400;1416407808;24016;612529;636545;564497;0.002811;quickSort
40500;1424497808;24116;614329;638445;566097;0.002831;quickSort
40600;1432607808;24216;616129;640345;567697;0.002847;quickSort
40700;1440737808;24316;617929;642245;569297;0.002850;quickSort
40800;1448887808;24416;619729;644145;570897;0.002839;quickSort
41100;1473457808;24716;625129;649845;575697;0.002883;quickSort
41200;1481687808;24816;626929;651745;577297;0.003688;quickSort
41300;1489937808;24916;628729;653645;578897;0.002910;quickSort
41400;1498207808;25016;630529;655545;580497;0.002899;quickSort
41500;1506497808;25116;632329;657445;582097;0.003379;quickSort
41600;1514807808;25216;634129;659345;583697;0.005642;quickSort
41700;1523137808;25316;635929;661245;585297;0.002926;quickSort
41800;1531487808;25416;637729;663145;586897;0.003221;quickSort
41900;1539857808;25516;639529;665045;588497;0.002959;quickSort
42000;1548247808;25616;641329;666945;590097;0.003161;quickSort
42100;1556657808;25716;643129;668845;591697;0.003266;quickSort
42200;1565087808;25816;644929;670745;593297;0.003030;quickSort
42300;1573537808;25916;646729;672645;594897;0.003478;quickSort
42400;1582007808;26016;648529;674545;596497;0.003012;quickSort
42500;1590497808;26116;650329;676445;598097;0.003461;quickSort
42600;1599007808;26216;652129;678345;599697;0.003454;quickSort
42700;1607537808;26316;653929;680245;601297;0.003939;quickSort
42800;1616087808;26416;655729;682145;602897;0.004440;quickSort
42900;1624657808;26516;657529;684045;604497;0.003203;quickSort
43000;1633247808;26616;659329;685945;606097;0.003058;quickSort
43100;1641857808;26716;661129;687845;607697;0.003124;quickSort
43200;1650487808;26816;662929;689745;609297;0.003121;quickSort
43300;1659137808;26916;664729;691645;610897;0.003165;quickSort
43400;1667807808;27016;666529;693545;612497;0.003123;quickSort
43500;1676497808;27116;668329;695445;614097;0.003144;quickSort
43600;1685207808;27216;670129;697345;615697;0.003186;quickSort
43700;1693937808;27316;671929;699245;617297;0.003161;quickSort
43800;1702687808;27416;673729;701145;618897;0.003142;quickSort
43900;1711457808;27516;675529;703045;620497;0.003176;quickSort
44000;1720247808;27616;677329;704945;622097;0.003446;quickSort
44100;1729057808;27716;679129;706845;623697;0.003288;quickSort
44200;1737887808;27816;680929;708745;625297;0.003520;quickSort
44300;1746737808;27916;682729;710645;626897;0.003829;quickSort
44400;1755607808;28016;684529;712545;628497;0.003183;quickSort
44500;1764497808;28116;686329;714445;630097;0.003254;quickSort
44600;1773407808;28216;688129;716345;631697;0.003190;quickSort
44700;1782337808;28316;689929;718245;633297;0.003404;quickSort
44800;1791287808;28416;691729;720145;634897;0.003748;quickSort
44900;1800257808;28516;693529;722045;636497;0.003477;quickSort
45000;1809247808;28616;695329;723945;638097;0.008729;quickSort
45100;1818257808;28716;697129;725845;639697;0.003612;quickSort
45200;1827287808;28816;698929;727745;641297;0.004120;quickSort
45300;1836337808;28916;700729;729645;642897;0.007824;quickSort
45400;1845407808;29016;702529;731545;644497;0.003407;quickSort
45500;1854497808;29116;704329;733445;646097;0.003710;quickSort
45600;1863607808;29216;706129;735345;647697;0.003545;quickSort
45700;1872737808;29316;707929;737245;649297;0.003747;quickSort
45800;1881887808;29416;709729;739145;650897;0.008248;quickSort
45900;1891057808;29516;711529;741045;652497;0.003503;quickSort
46000;1900247808;29616;713329;742945;654097;0.003812;quickSort
46100;1909457808;29716;715129;744845;655697;0.005216;quickSort
46200;1918687808;29816;716929;746745;657297;0.003790;quickSort
46300;1927937808;29916;718729;748645;658897;0.003371;quickSort
46400;1937207808;30016;720529;750545;660497;0.003866;quickSort
46500;1946497808;30116;722329;752445;662097;0.003902;quickSort
46600;1955807808;30216;724129;754345;663697;0.005080;quickSort
46700;1965137808;30316;725929;756245;665297;0.003826;quickSort
46800;1974487808;30416;727729;758145;666897;0.003675;quickSort
46900;1983857808;30516;729529;760045;668497;0.010657;quickSort
47000;1993247808;30616;731329;761945;670097;0.003561;quickSort
47100;11002657808;30716;733129;763845;671697;0.004123;quickSort
47200;11012087808;30816;734929;765745;673297;0.003594;quickSort
47300;11021537808;30916;736729;767645;674897;0.004218;quickSort
47400;11031007808;31016;738529;769545;676497;0.003937;quickSort
47500;11040497808;31116;740329;771445;678097;0.004239;quickSort
47600;11050007808;31216;742129;773345;679697;0.003964;quickSort
47700;11059537808;31316;743929;775245;681297;0.003413;quickSort
47800;11069087808;31416;745729;777145;682897;0.004040;quickSort
47900;11078657808;31516;747529;779045;684497;0.003891;quickSort
48000;11088247808;31616;749329;780945;686097;0.003775;quickSort
48100;11097857808;31716;751129;782845;687697;0.003522;quickSort
48200;11107487808;31816;752929;784745;689297;0.003446;quickSort
48300;11117137808;31916;754729;786645;690897;0.003742;quickSort
48400;11126807808;32016;756529;788545;692497;0.003462;quickSort
48500;11136497808;32116;758329;790445;694097;0.004021;quickSort
48600;11146207808;32216;760129;792345;695697;0.004131;quickSort
48700;11155937808;32316;761929;794245;697297;0.004051;quickSort
48800;11165687808;32416;763729;796145;698897;0.003553;quickSort
48900;11175457808;32516;765529;798045;700497;0.003562;quickSort
49000;11185247808;32616;767329;799945;702097;0.003594;quickSort
49100;11195057808;32716;769129;801845;703697;0.003525;quickSort
49200;11204887808;32767;770782;803549;705248;0.003554;quickSort
49400;2008855616;32767;773782;806549;708248;0.003717;quickSort
49500;2018745616;32767;775282;808049;709748;0.003693;quickSort
49600;2028655616;32767;776782;809549;711248;0.003646;quickSort
49700;2038585616;32767;778282;811049;712748;0.003762;quickSort
49800;2048535616;32767;779782;812549;714248;0.003628;quickSort
49900;2058505616;32767;781282;814049;715748;0.003643;quickSort
50000;2068495616;32767;782782;815549;717248;0.003673;quickSort
50100;2078505616;32767;784282;817049;718748;0.004130;quickSort
50200;2088535616;32767;785782;818549;720248;0.003718;quickSort
50300;2098585616;32767;787282;820049;721748;0.003727;quickSort
50400;2108655616;32767;788782;821549;723248;0.003728;quickSort
50500;2118745616;32767;790282;823049;724748;0.003692;quickSort
50600;2128855616;32767;791782;824549;726248;0.004148;quickSort
50700;2138985616;32767;793282;826049;727748;0.003958;quickSort
50800;2149135616;32767;794782;827549;729248;0.003751;quickSort
50900;2159305616;32767;796282;829049;730748;0.003763;quickSort
51000;2169495616;32767;797782;830549;732248;0.003727;quickSort
51100;2179705616;32767;799282;832049;733748;0.003736;quickSort
51200;2189935616;32767;800782;833549;735248;0.003755;quickSort
51300;2200185616;32767;802282;835049;736748;0.003747;quickSort
51400;2210455616;32767;803782;836549;738248;0.003758;quickSort
51500;2220745616;32767;805282;838049;739748;0.003971;quickSort
51600;2231055616;32767;806782;839549;741248;0.004189;quickSort
51700;2241385616;32767;808282;841049;742748;0.003948;quickSort
51800;2251735616;32767;809782;842549;744248;0.004508;quickSort
51900;2262105616;32767;811282;844049;745748;0.004304;quickSort
52000;2272495616;32767;812782;845549;747248;0.005024;quickSort
52100;2282905616;32767;814282;847049;748748;0.004231;quickSort
52200;2293335616;32767;815782;848549;750248;0.003796;quickSort
52300;2303785616;32767;817282;850049;751748;0.004389;quickSort
52400;2314255616;32767;818782;851549;753248;0.004076;quickSort
52500;2324745616;32767;820282;853049;754748;0.003850;quickSort
52600;2335255616;32767;821782;854549;756248;0.004723;quickSort
52700;2345785616;32767;823282;856049;757748;0.005938;quickSort
52800;2356335616;32767;824782;857549;759248;0.004681;quickSort
52900;2366905616;32767;826282;859049;760748;0.004210;quickSort
53000;2377495616;32767;827782;860549;762248;0.004048;quickSort
53100;2388105616;32767;829282;862049;763748;0.004194;quickSort
53200;2398735616;32767;830782;863549;765248;0.004821;quickSort
53300;2409385616;32767;832282;865049;766748;0.004968;quickSort
53400;2420055616;32767;833782;866549;768248;0.004462;quickSort
53500;2430745616;32767;835282;868049;769748;0.004037;quickSort
53600;2441455616;32767;836782;869549;771248;0.004522;quickSort
53700;2452185616;32767;838282;871049;772748;0.004382;quickSort
53800;2462935616;32767;839782;872549;774248;0.004662;quickSort
53900;2473705616;32767;841282;874049;775748;0.004687;quickSort
54000;2484495616;32767;842782;875549;777248;0.004313;quickSort
54100;2495305616;32767;844282;877049;778748;0.004170;quickSort
54200;2506135616;32767;845782;878549;780248;0.004545;quickSort
54300;2516985616;32767;847282;880049;781748;0.004907;quickSort
54400;2527855616;32767;848782;881549;783248;0.004479;quickSort
54500;2538745616;32767;850282;883049;784748;0.004040;quickSort
54600;2549655616;32767;851782;884549;786248;0.004321;quickSort
54700;2560585616;32767;853282;886049;787748;0.004530;quickSort
54800;2571535616;32767;854782;887549;789248;0.004108;quickSort
54900;2582505616;32767;856282;889049;790748;0.004262;quickSort
55000;2593495616;32767;857782;890549;792248;0.004303;quickSort
55100;2604505616;32767;859282;892049;793748;0.007119;quickSort
55200;2615535616;32767;860782;893549;795248;0.004916;quickSort
55300;2626585616;32767;862282;895049;796748;0.004522;quickSort
55400;2637655616;32767;863782;896549;798248;0.004433;quickSort
55500;2648745616;32767;865282;898049;799748;0.004425;quickSort
55600;2659855616;32767;866782;899549;801248;0.004810;quickSort
55700;2670985616;32767;868282;901049;802748;0.005459;quickSort
55800;2682135616;32767;869782;902549;804248;0.004480;quickSort
55900;2693305616;32767;871282;904049;805748;0.004045;quickSort
56000;2704495616;32767;872782;905549;807248;0.004060;quickSort
56100;2715705616;32767;874282;907049;808748;0.004563;quickSort
56200;2726935616;32767;875782;908549;810248;0.004238;quickSort
56300;2738185616;32767;877282;910049;811748;0.004132;quickSort
56400;2749455616;32767;878782;911549;813248;0.004520;quickSort
56500;2760745616;32767;880282;913049;814748;0.004054;quickSort
56600;2772055616;32767;881782;914549;816248;0.004137;quickSort
56700;2783385616;32767;883282;916049;817748;0.004604;quickSort
56800;2794735616;32767;884782;917549;819248;0.003983;quickSort
56900;2806105616;32767;886282;919049;820748;0.004145;quickSort
57000;2817495616;32767;887782;920549;822248;0.004186;quickSort
57100;2828905616;32767;889282;922049;823748;0.004122;quickSort
57200;2840335616;32767;890782;923549;825248;0.004050;quickSort
57300;2851785616;32767;892282;925049;826748;0.004441;quickSort
57400;2863255616;32767;893782;926549;828248;0.004288;quickSort
57500;2874745616;32767;895282;928049;829748;0.004113;quickSort
57600;2886255616;32767;896782;929549;831248;0.005817;quickSort
57700;2897785616;32767;898282;931049;832748;0.004503;quickSort
57800;2909335616;32767;899782;932549;834248;0.005872;quickSort
57900;2920905616;32767;901282;934049;835748;0.006306;quickSort
58000;2932495616;32767;902782;935549;837248;0.004398;quickSort
58100;2944105616;32767;904282;937049;838748;0.004773;quickSort
58200;2955735616;32767;905782;938549;840248;0.007313;quickSort
58400;2979055616;32767;908782;941549;843248;0.004642;quickSort
58500;2990745616;32767;910282;943049;844748;0.005258;quickSort
58600;21002455616;32767;911782;944549;846248;0.004908;quickSort
58700;21014185616;32767;913282;946049;847748;0.004767;quickSort
58800;21025935616;32767;914782;947549;849248;0.004858;quickSort
58900;21037705616;32767;916282;949049;850748;0.004565;quickSort
59000;21049495616;32767;917782;950549;852248;0.004996;quickSort
59100;21061305616;32767;919282;952049;853748;0.005142;quickSort
59200;21073135616;32767;920782;953549;855248;0.005280;quickSort
59300;21084985616;32767;922282;955049;856748;0.004667;quickSort
59400;21096855616;32767;923782;956549;858248;0.004369;quickSort
59500;21108745616;32767;925282;958049;859748;0.004173;quickSort
59600;21120655616;32767;926782;959549;861248;0.004808;quickSort
59700;21132585616;32767;928282;961049;862748;0.004784;quickSort
59800;21144535616;32767;929782;962549;864248;0.004543;quickSort
59900;21156505616;32767;931282;964049;865748;0.004696;quickSort
60000;21168495616;32767;932782;965549;867248;0.004688;quickSort
60100;21180505616;32767;934282;967049;868748;0.004834;quickSort
60200;21192535616;32767;935782;968549;870248;0.004826;quickSort
60300;21204585616;32767;937282;970049;871748;0.004535;quickSort
60400;3000903424;32767;938782;971549;873248;0.004737;quickSort
60500;3012993424;32767;940282;973049;874748;0.004309;quickSort
60600;3025103424;32767;941782;974549;876248;0.004463;quickSort
60700;3037233424;32767;943282;976049;877748;0.004734;quickSort
60800;3049383424;32767;944782;977549;879248;0.004571;quickSort
60900;3061553424;32767;946282;979049;880748;0.004177;quickSort
61000;3073743424;32767;947782;980549;882248;0.004200;quickSort
61100;3085953424;32767;949282;982049;883748;0.004205;quickSort
61200;3098183424;32767;950782;983549;885248;0.004274;quickSort
61300;3110433424;32767;952282;985049;886748;0.004269;quickSort
61400;3122703424;32767;953782;986549;888248;0.004292;quickSort
61500;3134993424;32767;955282;988049;889748;0.004275;quickSort
61600;3147303424;32767;956782;989549;891248;0.004295;quickSort
61700;3159633424;32767;958282;991049;892748;0.004463;quickSort
61800;3171983424;32767;959782;992549;894248;0.004529;quickSort
61900;3184353424;32767;961282;994049;895748;0.004352;quickSort
62000;3196743424;32767;962782;995549;897248;0.004394;quickSort
62100;3209153424;32767;964282;997049;898748;0.004959;quickSort
62200;3221583424;32767;965782;998549;900248;0.004512;quickSort
62300;3234033424;32767;967282;1000049;901748;0.004591;quickSort
62400;3246503424;32767;968782;1001549;903248;0.005023;quickSort
62500;3258993424;32767;970282;1003049;904748;0.004388;quickSort
62600;3271503424;32767;971782;1004549;906248;0.004370;quickSort
62700;3284033424;32767;973282;1006049;907748;0.005158;quickSort
62800;3296583424;32767;974782;1007549;909248;0.005009;quickSort
62900;3309153424;32767;976282;1009049;910748;0.004389;quickSort
63000;3321743424;32767;977782;1010549;912248;0.005067;quickSort
63100;3334353424;32767;979282;1012049;913748;0.005029;quickSort
63200;3346983424;32767;980782;1013549;915248;0.005445;quickSort
63300;3359633424;32767;982282;1015049;916748;0.004731;quickSort
63400;3372303424;32767;983782;1016549;918248;0.005063;quickSort
63500;3384993424;32767;985282;1018049;919748;0.004697;quickSort
63600;3397703424;32767;986782;1019549;921248;0.005114;quickSort
63700;3410433424;32767;988282;1021049;922748;0.004959;quickSort
63800;3423183424;32767;989782;1022549;924248;0.004864;quickSort
63900;3435953424;32767;991282;1024049;925748;0.004751;quickSort
64000;3448743424;32767;992782;1025549;927248;0.005185;quickSort
64100;3461553424;32767;994282;1027049;928748;0.005380;quickSort
64200;3474383424;32767;995782;1028549;930248;0.004952;quickSort
64300;3487233424;32767;997282;1030049;931748;0.004550;quickSort
64400;3500103424;32767;998782;1031549;933248;0.005635;quickSort
64500;3512993424;32767;1000282;1033049;934748;0.005014;quickSort
64600;3525903424;32767;1001782;1034549;936248;0.004776;quickSort
64700;3538833424;32767;1003282;1036049;937748;0.006088;quickSort
64800;3551783424;32767;1004782;1037549;939248;0.004644;quickSort
64900;3564753424;32767;1006282;1039049;940748;0.004503;quickSort
65000;3577743424;32767;1007782;1040549;942248;0.004398;quickSort
65100;3590753424;32767;1009282;1042049;943748;0.004672;quickSort
65200;3603783424;32767;1010782;1043549;945248;0.004541;quickSort
65300;3616833424;32767;1012282;1045049;946748;0.004540;quickSort
65400;3629903424;32767;1013782;1046549;948248;0.004421;quickSort
65500;3642993424;32767;1015282;1048049;949748;0.004445;quickSort
65600;3656103424;32832;1017042;1049874;951378;0.004500;quickSort
65700;3669233424;32932;1018942;1051874;953078;0.004521;quickSort
65800;3682383424;33032;1020842;1053874;954778;0.004614;quickSort
65900;3695553424;33132;1022742;1055874;956478;0.004446;quickSort
66000;3708743424;33232;1024642;1057874;958178;0.004522;quickSort
66100;3721953424;33332;1026542;1059874;959878;0.004674;quickSort
66200;3735183424;33432;1028442;1061874;961578;0.004571;quickSort
66300;3748433424;33532;1030342;1063874;963278;0.004598;quickSort
66400;3761703424;33632;1032242;1065874;964978;0.004631;quickSort
66500;3774993424;33732;1034142;1067874;966678;0.004611;quickSort
66600;3788303424;33832;1036042;1069874;968378;0.004604;quickSort
66700;3801633424;33932;1037942;1071874;970078;0.005625;quickSort
66800;3814983424;34032;1039842;1073874;971778;0.005530;quickSort
66900;3828353424;34132;1041742;1075874;973478;0.005303;quickSort
67000;3841743424;34232;1043642;1077874;975178;0.004825;quickSort
67100;3855153424;34332;1045542;1079874;976878;0.004822;quickSort
67200;3868583424;34432;1047442;1081874;978578;0.004672;quickSort
67300;3882033424;34532;1049342;1083874;980278;0.004826;quickSort
67400;3895503424;34632;1051242;1085874;981978;0.004763;quickSort
67500;3908993424;34732;1053142;1087874;983678;0.004711;quickSort
67600;3922503424;34832;1055042;1089874;985378;0.005181;quickSort
67700;3936033424;34932;1056942;1091874;987078;0.004907;quickSort
67800;3949583424;35032;1058842;1093874;988778;0.004920;quickSort
67900;3963153424;35132;1060742;1095874;990478;0.004939;quickSort
68000;3976743424;35232;1062642;1097874;992178;0.004742;quickSort
68100;3990353424;35332;1064542;1099874;993878;0.004787;quickSort
68200;31003983424;35432;1066442;1101874;995578;0.004799;quickSort
68300;31017633424;35532;1068342;1103874;997278;0.004790;quickSort
68400;31031303424;35632;1070242;1105874;998978;0.004813;quickSort
68500;31044993424;35732;1072142;1107874;1000678;0.004810;quickSort
68600;31058703424;35832;1074042;1109874;1002378;0.004820;quickSort
68700;31072433424;35932;1075942;1111874;1004078;0.004866;quickSort
68800;31086183424;36032;1077842;1113874;1005778;0.004842;quickSort
68900;31099953424;36132;1079742;1115874;1007478;0.004846;quickSort
69000;31113743424;36232;1081642;1117874;1009178;0.004912;quickSort
69100;31127553424;36332;1083542;1119874;1010878;0.004964;quickSort
69200;31141383424;36432;1085442;1121874;1012578;0.005132;quickSort
69400;31169103424;36632;1089242;1125874;1015978;0.004961;quickSort
69500;31182993424;36732;1091142;1127874;1017678;0.004964;quickSort
69600;31196903424;36832;1093042;1129874;1019378;0.004994;quickSort
69700;31210833424;36932;1094942;1131874;1021078;0.004991;quickSort
69800;4009031232;37032;1096842;1133874;1022778;0.004989;quickSort
69900;4023001232;37132;1098742;1135874;1024478;0.005528;quickSort
70000;4036991232;37232;1100642;1137874;1026178;0.005007;quickSort
70100;4051001232;37332;1102542;1139874;1027878;0.004943;quickSort
70200;4065031232;37432;1104442;1141874;1029578;0.004992;quickSort
70300;4079081232;37532;1106342;1143874;1031278;0.004972;quickSort
70400;4093151232;37632;1108242;1145874;1032978;0.004975;quickSort
70500;4107241232;37732;1110142;1147874;1034678;0.005008;quickSort
70600;4121351232;37832;1112042;1149874;1036378;0.005004;quickSort
70700;4135481232;37932;1113942;1151874;1038078;0.005017;quickSort
70800;4149631232;38032;1115842;1153874;1039778;0.005019;quickSort
70900;4163801232;38132;1117742;1155874;1041478;0.005020;quickSort
71000;4177991232;38232;1119642;1157874;1043178;0.005047;quickSort
71100;4192201232;38332;1121542;1159874;1044878;0.005050;quickSort
71200;4206431232;38432;1123442;1161874;1046578;0.005053;quickSort
71300;4220681232;38532;1125342;1163874;1048278;0.005061;quickSort
71400;4234951232;38632;1127242;1165874;1049978;0.005068;quickSort
71500;4249241232;38732;1129142;1167874;1051678;0.005463;quickSort
71600;4263551232;38832;1131042;1169874;1053378;0.005086;quickSort
71700;4277881232;38932;1132942;1171874;1055078;0.005109;quickSort
71800;4292231232;39032;1134842;1173874;1056778;0.005120;quickSort
71900;4306601232;39132;1136742;1175874;1058478;0.005116;quickSort
72000;4320991232;39232;1138642;1177874;1060178;0.005153;quickSort
72100;4335401232;39332;1140542;1179874;1061878;0.005684;quickSort
72200;4349831232;39432;1142442;1181874;1063578;0.005145;quickSort
72300;4364281232;39532;1144342;1183874;1065278;0.005188;quickSort
72400;4378751232;39632;1146242;1185874;1066978;0.005641;quickSort
72500;4393241232;39732;1148142;1187874;1068678;0.005158;quickSort
72600;4407751232;39832;1150042;1189874;1070378;0.005171;quickSort
72700;4422281232;39932;1151942;1191874;1072078;0.005188;quickSort
72800;4436831232;40032;1153842;1193874;1073778;0.005188;quickSort
72900;4451401232;40132;1155742;1195874;1075478;0.005265;quickSort
73000;4465991232;40232;1157642;1197874;1077178;0.005603;quickSort
73100;4480601232;40332;1159542;1199874;1078878;0.005211;quickSort
73200;4495231232;40432;1161442;1201874;1080578;0.005238;quickSort
73300;4509881232;40532;1163342;1203874;1082278;0.005220;quickSort
73400;4524551232;40632;1165242;1205874;1083978;0.005245;quickSort
73500;4539241232;40732;1167142;1207874;1085678;0.005229;quickSort
73600;4553951232;40832;1169042;1209874;1087378;0.005252;quickSort
73700;4568681232;40932;1170942;1211874;1089078;0.005116;quickSort
73800;4583431232;41032;1172842;1213874;1090778;0.005136;quickSort
73900;4598201232;41132;1174742;1215874;1092478;0.005157;quickSort
74000;4612991232;41232;1176642;1217874;1094178;0.005139;quickSort
74100;4627801232;41332;1178542;1219874;1095878;0.005162;quickSort
74200;4642631232;41432;1180442;1221874;1097578;0.005163;quickSort
74300;4657481232;41532;1182342;1223874;1099278;0.005273;quickSort
74400;4672351232;41632;1184242;1225874;1100978;0.005197;quickSort
74500;4687241232;41732;1186142;1227874;1102678;0.005193;quickSort
74600;4702151232;41832;1188042;1229874;1104378;0.005207;quickSort
74700;4717081232;41932;1189942;1231874;1106078;0.005350;quickSort
74800;4732031232;42032;1191842;1233874;1107778;0.005367;quickSort
74900;4747001232;42132;1193742;1235874;1109478;0.005368;quickSort
75000;4761991232;42232;1195642;1237874;1111178;0.005387;quickSort
75100;4777001232;42332;1197542;1239874;1112878;0.005387;quickSort
75200;4792031232;42432;1199442;1241874;1114578;0.005403;quickSort
75300;4807081232;42532;1201342;1243874;1116278;0.005471;quickSort
75400;4822151232;42632;1203242;1245874;1117978;0.005750;quickSort
75500;4837241232;42732;1205142;1247874;1119678;0.005749;quickSort
75600;4852351232;42832;1207042;1249874;1121378;0.005645;quickSort
75700;4867481232;42932;1208942;1251874;1123078;0.005626;quickSort
75800;4882631232;43032;1210842;1253874;1124778;0.005562;quickSort
75900;4897801232;43132;1212742;1255874;1126478;0.005492;quickSort
76000;4912991232;43232;1214642;1257874;1128178;0.005722;quickSort
76100;4928201232;43332;1216542;1259874;1129878;0.006090;quickSort
76200;4943431232;43432;1218442;1261874;1131578;0.005508;quickSort
76300;4958681232;43532;1220342;1263874;1133278;0.005520;quickSort
76400;4973951232;43632;1222242;1265874;1134978;0.005506;quickSort
76500;4989241232;43732;1224142;1267874;1136678;0.005539;quickSort
76600;41004551232;43832;1226042;1269874;1138378;0.005527;quickSort
76700;41019881232;43932;1227942;1271874;1140078;0.006120;quickSort
76800;41035231232;44032;1229842;1273874;1141778;0.005555;quickSort
76900;41050601232;44132;1231742;1275874;1143478;0.005559;quickSort
77000;41065991232;44232;1233642;1277874;1145178;0.005865;quickSort
77100;41081401232;44332;1235542;1279874;1146878;0.006040;quickSort
77200;41096831232;44432;1237442;1281874;1148578;0.005624;quickSort
77300;41112281232;44532;1239342;1283874;1150278;0.005550;quickSort
77400;41127751232;44632;1241242;1285874;1151978;0.005773;quickSort
77500;41143241232;44732;1243142;1287874;1153678;0.006160;quickSort
77600;41158751232;44832;1245042;1289874;1155378;0.005646;quickSort
77700;41174281232;44932;1246942;1291874;1157078;0.005509;quickSort
77800;41189831232;45032;1248842;1293874;1158778;0.005501;quickSort
77900;41205401232;45132;1250742;1295874;1160478;0.006765;quickSort
78000;5005239040;45232;1252642;1297874;1162178;0.005624;quickSort
78100;5020849040;45332;1254542;1299874;1163878;0.005663;quickSort
78200;5036479040;45432;1256442;1301874;1165578;0.005643;quickSort
78300;5052129040;45532;1258342;1303874;1167278;0.005673;quickSort
78400;5067799040;45632;1260242;1305874;1168978;0.005704;quickSort
78500;5083489040;45732;1262142;1307874;1170678;0.005692;quickSort
78600;5099199040;45832;1264042;1309874;1172378;0.005706;quickSort
78700;5114929040;45932;1265942;1311874;1174078;0.005716;quickSort
78800;5130679040;46032;1267842;1313874;1175778;0.005750;quickSort
78900;5146449040;46132;1269742;1315874;1177478;0.005743;quickSort
79000;5162239040;46232;1271642;1317874;1179178;0.006210;quickSort
79100;5178049040;46332;1273542;1319874;1180878;0.006471;quickSort
79200;5193879040;46432;1275442;1321874;1182578;0.006421;quickSort
79300;5209729040;46532;1277342;1323874;1184278;0.005910;quickSort
79400;5225599040;46632;1279242;1325874;1185978;0.006411;quickSort
79500;5241489040;46732;1281142;1327874;1187678;0.005687;quickSort
79600;5257399040;46832;1283042;1329874;1189378;0.005684;quickSort
79700;5273329040;46932;1284942;1331874;1191078;0.006507;quickSort
79800;5289279040;47032;1286842;1333874;1192778;0.005849;quickSort
79900;5305249040;47132;1288742;1335874;1194478;0.005823;quickSort
80000;5321239040;47232;1290642;1337874;1196178;0.005852;quickSort
80100;5337249040;47332;1292542;1339874;1197878;0.006390;quickSort
80200;5353279040;47432;1294442;1341874;1199578;0.005868;quickSort
80300;5369329040;47532;1296342;1343874;1201278;0.005878;quickSort
80400;5385399040;47632;1298242;1345874;1202978;0.006402;quickSort
80500;5401489040;47732;1300142;1347874;1204678;0.005896;quickSort
80600;5417599040;47832;1302042;1349874;1206378;0.006390;quickSort
80700;5433729040;47932;1303942;1351874;1208078;0.005897;quickSort
80800;5449879040;48032;1305842;1353874;1209778;0.005755;quickSort
80900;5466049040;48132;1307742;1355874;1211478;0.005777;quickSort
81000;5482239040;48232;1309642;1357874;1213178;0.005772;quickSort
81100;5498449040;48332;1311542;1359874;1214878;0.005788;quickSort
81200;5514679040;48432;1313442;1361874;1216578;0.006413;quickSort
81300;5530929040;48532;1315342;1363874;1218278;0.005805;quickSort
81400;5547199040;48632;1317242;1365874;1219978;0.005810;quickSort
81500;5563489040;48732;1319142;1367874;1221678;0.005811;quickSort
81600;5579799040;48832;1321042;1369874;1223378;0.005988;quickSort
81700;5596129040;48932;1322942;1371874;1225078;0.005988;quickSort
81800;5612479040;49032;1324842;1373874;1226778;0.006000;quickSort
81900;5628849040;49132;1326742;1375874;1228478;0.005986;quickSort
82000;5645239040;49232;1328642;1377874;1230178;0.006161;quickSort
82100;5661649040;49332;1330542;1379874;1231878;0.006030;quickSort
82200;5678079040;49432;1332442;1381874;1233578;0.006049;quickSort
82300;5694529040;49532;1334342;1383874;1235278;0.006050;quickSort
82400;5710999040;49632;1336242;1385874;1236978;0.006077;quickSort
82500;5727489040;49732;1338142;1387874;1238678;0.006089;quickSort
82600;5743999040;49832;1340042;1389874;1240378;0.006593;quickSort
82700;5760529040;49932;1341942;1391874;1242078;0.006096;quickSort
82800;5777079040;50032;1343842;1393874;1243778;0.006107;quickSort
82900;5793649040;50132;1345742;1395874;1245478;0.006118;quickSort
83000;5810239040;50232;1347642;1397874;1247178;0.006117;quickSort
83100;5826849040;50332;1349542;1399874;1248878;0.006157;quickSort
83200;5843479040;50432;1351442;1401874;1250578;0.006151;quickSort
83300;5860129040;50532;1353342;1403874;1252278;0.006755;quickSort
83400;5876799040;50632;1355242;1405874;1253978;0.006183;quickSort
83500;5893489040;50732;1357142;1407874;1255678;0.006189;quickSort
83600;5910199040;50832;1359042;1409874;1257378;0.006204;quickSort
83700;5926929040;50932;1360942;1411874;1259078;0.006242;quickSort
83800;5943679040;51032;1362842;1413874;1260778;0.006210;quickSort
83900;5960449040;51132;1364742;1415874;1262478;0.006234;quickSort
84000;5977239040;51232;1366642;1417874;1264178;0.006228;quickSort
84100;5994049040;51332;1368542;1419874;1265878;0.006134;quickSort
84200;51010879040;51432;1370442;1421874;1267578;0.006095;quickSort
84300;51027729040;51532;1372342;1423874;1269278;0.006138;quickSort
84400;51044599040;51632;1374242;1425874;1270978;0.006726;quickSort
84500;51061489040;51732;1376142;1427874;1272678;0.006129;quickSort
84700;51095329040;51932;1379942;1431874;1276078;0.006161;quickSort
84800;51112279040;52032;1381842;1433874;1277778;0.006408;quickSort
84900;51129249040;52132;1383742;1435874;1279478;0.006337;quickSort
85000;51146239040;52232;1385642;1437874;1281178;0.007347;quickSort
85100;51163249040;52332;1387542;1439874;1282878;0.006879;quickSort
85200;51180279040;52432;1389442;1441874;1284578;0.006562;quickSort
85300;51197329040;52532;1391342;1443874;1286278;0.006596;quickSort
85400;51214399040;52632;1393242;1445874;1287978;0.006390;quickSort
85500;6015736848;52732;1395142;1447874;1289678;0.006994;quickSort
85600;6032846848;52832;1397042;1449874;1291378;0.007064;quickSort
85700;6049976848;52932;1398942;1451874;1293078;0.006437;quickSort
85800;6067126848;53032;1400842;1453874;1294778;0.006417;quickSort
85900;6084296848;53132;1402742;1455874;1296478;0.006457;quickSort
86000;6101486848;53232;1404642;1457874;1298178;0.007707;quickSort
86100;6118696848;53332;1406542;1459874;1299878;0.006451;quickSort
86200;6135926848;53432;1408442;1461874;1301578;0.006470;quickSort
86300;6153176848;53532;1410342;1463874;1303278;0.006480;quickSort
86400;6170446848;53632;1412242;1465874;1304978;0.006476;quickSort
86500;6187736848;53732;1414142;1467874;1306678;0.006490;quickSort
86600;6205046848;53832;1416042;1469874;1308378;0.006497;quickSort
86700;6222376848;53932;1417942;1471874;1310078;0.006510;quickSort
86800;6239726848;54032;1419842;1473874;1311778;0.006530;quickSort
86900;6257096848;54132;1421742;1475874;1313478;0.006519;quickSort
87000;6274486848;54232;1423642;1477874;1315178;0.007004;quickSort
87100;6291896848;54332;1425542;1479874;1316878;0.006558;quickSort
87200;6309326848;54432;1427442;1481874;1318578;0.006580;quickSort
87300;6326776848;54532;1429342;1483874;1320278;0.006588;quickSort
87400;6344246848;54632;1431242;1485874;1321978;0.006587;quickSort
87500;6361736848;54732;1433142;1487874;1323678;0.006636;quickSort
87600;6379246848;54832;1435042;1489874;1325378;0.006696;quickSort
87700;6396776848;54932;1436942;1491874;1327078;0.007116;quickSort
87800;6414326848;55032;1438842;1493874;1328778;0.006602;quickSort
87900;6431896848;55132;1440742;1495874;1330478;0.006616;quickSort
88000;6449486848;55232;1442642;1497874;1332178;0.007167;quickSort
88100;6467096848;55332;1444542;1499874;1333878;0.006633;quickSort
88200;6484726848;55432;1446442;1501874;1335578;0.006647;quickSort
88300;6502376848;55532;1448342;1503874;1337278;0.006641;quickSort
88400;6520046848;55632;1450242;1505874;1338978;0.006672;quickSort
88500;6537736848;55732;1452142;1507874;1340678;0.006669;quickSort
88600;6555446848;55832;1454042;1509874;1342378;0.006685;quickSort
88700;6573176848;55932;1455942;1511874;1344078;0.006678;quickSort
88800;6590926848;56032;1457842;1513874;1345778;0.006673;quickSort
88900;6608696848;56132;1459742;1515874;1347478;0.006693;quickSort
89000;6626486848;56232;1461642;1517874;1349178;0.006711;quickSort
89100;6644296848;56332;1463542;1519874;1350878;0.006705;quickSort
89200;6662126848;56432;1465442;1521874;1352578;0.006725;quickSort
89300;6679976848;56532;1467342;1523874;1354278;0.006747;quickSort
89400;6697846848;56632;1469242;1525874;1355978;0.006749;quickSort
89500;6715736848;56732;1471142;1527874;1357678;0.006745;quickSort
89600;6733646848;56832;1473042;1529874;1359378;0.006762;quickSort
89700;6751576848;56932;1474942;1531874;1361078;0.006754;quickSort
89800;6769526848;57032;1476842;1533874;1362778;0.006776;quickSort
89900;6787496848;57132;1478742;1535874;1364478;0.007106;quickSort
90000;6805486848;57232;1480642;1537874;1366178;0.006796;quickSort
90100;6823496848;57332;1482542;1539874;1367878;0.007396;quickSort
90200;6841526848;57432;1484442;1541874;1369578;0.007637;quickSort
90300;6859576848;57532;1486342;1543874;1371278;0.006781;quickSort
90400;6877646848;57632;1488242;1545874;1372978;0.006803;quickSort
90500;6895736848;57732;1490142;1547874;1374678;0.006836;quickSort
90600;6913846848;57832;1492042;1549874;1376378;0.006858;quickSort
90700;6931976848;57932;1493942;1551874;1378078;0.006833;quickSort
90800;6950126848;58032;1495842;1553874;1379778;0.007408;quickSort
90900;6968296848;58132;1497742;1555874;1381478;0.006865;quickSort
91000;6986486848;58232;1499642;1557874;1383178;0.006873;quickSort
91100;61004696848;58332;1501542;1559874;1384878;0.006880;quickSort
91200;61022926848;58432;1503442;1561874;1386578;0.006895;quickSort
91300;61041176848;58532;1505342;1563874;1388278;0.007995;quickSort
91400;61059446848;58632;1507242;1565874;1389978;0.006881;quickSort
91600;61096046848;58832;1511042;1569874;1393378;0.006919;quickSort
91700;61114376848;58932;1512942;1571874;1395078;0.006944;quickSort
91800;61132726848;59032;1514842;1573874;1396778;0.006936;quickSort
91900;61151096848;59132;1516742;1575874;1398478;0.006966;quickSort
92000;61169486848;59232;1518642;1577874;1400178;0.006940;quickSort
92100;61187896848;59332;1520542;1579874;1401878;0.006986;quickSort
92200;61206326848;59432;1522442;1581874;1403578;0.007564;quickSort
92300;7009024656;59532;1524342;1583874;1405278;0.007008;quickSort
92400;7027494656;59632;1526242;1585874;1406978;0.007019;quickSort
92500;7045984656;59732;1528142;1587874;1408678;0.007082;quickSort
92600;7064494656;59832;1530042;1589874;1410378;0.007280;quickSort
92700;7083024656;59932;1531942;1591874;1412078;0.007837;quickSort
92800;7101574656;60032;1533842;1593874;1413778;0.007036;quickSort
92900;7120144656;60132;1535742;1595874;1415478;0.007035;quickSort
93000;7138734656;60232;1537642;1597874;1417178;0.007051;quickSort
93100;7157344656;60332;1539542;1599874;1418878;0.007045;quickSort
93200;7175974656;60432;1541442;1601874;1420578;0.007073;quickSort
93300;7194624656;60532;1543342;1603874;1422278;0.007067;quickSort
93400;7213294656;60632;1545242;1605874;1423978;0.007091;quickSort
93500;7231984656;60732;1547142;1607874;1425678;0.007089;quickSort
93600;7250694656;60832;1549042;1609874;1427378;0.007103;quickSort
93700;7269424656;60932;1550942;1611874;1429078;0.007514;quickSort
93800;7288174656;61032;1552842;1613874;1430778;0.007119;quickSort
93900;7306944656;61132;1554742;1615874;1432478;0.007126;quickSort
94000;7325734656;61232;1556642;1617874;1434178;0.008307;quickSort
94100;7344544656;61332;1558542;1619874;1435878;0.007152;quickSort
94200;7363374656;61432;1560442;1621874;1437578;0.007159;quickSort
94300;7382224656;61532;1562342;1623874;1439278;0.007159;quickSort
94400;7401094656;61632;1564242;1625874;1440978;0.007219;quickSort
94500;7419984656;61732;1566142;1627874;1442678;0.007191;quickSort
94600;7438894656;61832;1568042;1629874;1444378;0.007210;quickSort
94700;7457824656;61932;1569942;1631874;1446078;0.007213;quickSort
94800;7476774656;62032;1571842;1633874;1447778;0.008666;quickSort
94900;7495744656;62132;1573742;1635874;1449478;0.007207;quickSort
95000;7514734656;62232;1575642;1637874;1451178;0.007273;quickSort
95100;7533744656;62332;1577542;1639874;1452878;0.007243;quickSort
95200;7552774656;62432;1579442;1641874;1454578;0.007438;quickSort
95300;7571824656;62532;1581342;1643874;1456278;0.007865;quickSort
95400;7590894656;62632;1583242;1645874;1457978;0.007836;quickSort
95500;7609984656;62732;1585142;1647874;1459678;0.007319;quickSort
95600;7629094656;62832;1587042;1649874;1461378;0.007295;quickSort
95700;7648224656;62932;1588942;1651874;1463078;0.007313;quickSort
95800;7667374656;63032;1590842;1653874;1464778;0.007287;quickSort
95900;7686544656;63132;1592742;1655874;1466478;0.007326;quickSort
96000;7705734656;63232;1594642;1657874;1468178;0.007343;quickSort
96100;7724944656;63332;1596542;1659874;1469878;0.007343;quickSort
96200;7744174656;63432;1598442;1661874;1471578;0.007363;quickSort
96300;7763424656;63532;1600342;1663874;1473278;0.007352;quickSort
96400;7782694656;63632;1602242;1665874;1474978;0.007364;quickSort
96500;7801984656;63732;1604142;1667874;1476678;0.007370;quickSort
96600;7821294656;63832;1606042;1669874;1478378;0.007400;quickSort
96700;7840624656;63932;1607942;1671874;1480078;0.007378;quickSort
96800;7859974656;64032;1609842;1673874;1481778;0.007413;quickSort
96900;7879344656;64132;1611742;1675874;1483478;0.007412;quickSort
97000;7898734656;64232;1613642;1677874;1485178;0.007667;quickSort
97100;7918144656;64332;1615542;1679874;1486878;0.008216;quickSort
97200;7937574656;64432;1617442;1681874;1488578;0.007463;quickSort
97300;7957024656;64532;1619342;1683874;1490278;0.007631;quickSort
97400;7976494656;64632;1621242;1685874;1491978;0.007467;quickSort
97500;7995984656;64732;1623142;1687874;1493678;0.007481;quickSort
97600;71015494656;64832;1625042;1689874;1495378;0.007496;quickSort
97700;71035024656;64932;1626942;1691874;1497078;0.007471;quickSort
97800;71054574656;65032;1628842;1693874;1498778;0.007515;quickSort
97900;71074144656;65132;1630742;1695874;1500478;0.007504;quickSort
98000;71093734656;65232;1632642;1697874;1502178;0.007500;quickSort
98100;71113344656;65332;1634542;1699874;1503878;0.007517;quickSort
98200;71132974656;65432;1636442;1701874;1505578;0.007527;quickSort
98300;71152624656;65532;1638342;1703874;1507278;0.007535;quickSort
98400;71172294656;65535;1639951;1705486;1508881;0.007532;quickSort
98500;71191984656;65535;1641551;1707086;1510481;0.007549;quickSort
98600;71211694656;65535;1643151;1708686;1512081;0.007556;quickSort
98700;8015672464;65535;1644751;1710286;1513681;0.007575;quickSort
98800;8035422464;65535;1646351;1711886;1515281;0.007563;quickSort
98900;8055192464;65535;1647951;1713486;1516881;0.008027;quickSort
99000;8074982464;65535;1649551;1715086;1518481;0.007648;quickSort
99100;8094792464;65535;1651151;1716686;1520081;0.007594;quickSort
99200;8114622464;65535;1652751;1718286;1521681;0.007636;quickSort
99300;8134472464;65535;1654351;1719886;1523281;0.007606;quickSort
99400;8154342464;65535;1655951;1721486;1524881;0.007630;quickSort
99500;8174232464;65535;1657551;1723086;1526481;0.007639;quickSort
99600;8194142464;65535;1659151;1724686;1528081;0.007657;quickSort
99700;8214072464;65535;1660751;1726286;1529681;0.007689;quickSort
99800;8234022464;65535;1662351;1727886;1531281;0.008160;quickSort
99900;8253992464;65535;1663951;1729486;1532881;0.007707;quickSort
100000;8273982464;65535;1665551;1731086;1534481;0.007698;quickSort
100100;8293992464;65535;1667151;1732686;1536081;0.007665;quickSort
100200;8314022464;65535;1668751;1734286;1537681;0.007717;quickSort
100300;8334072464;65535;1670351;1735886;1539281;0.008058;quickSort
100400;8354142464;65535;1671951;1737486;1540881;0.007735;quickSort
100500;8374232464;65535;1673551;1739086;1542481;0.009018;quickSort
100600;8394342464;65535;1675151;1740686;1544081;0.007735;quickSort
100700;8414472464;65535;1676751;1742286;1545681;0.007765;quickSort
100800;8434622464;65535;1678351;1743886;1547281;0.007789;quickSort
100900;8454792464;65535;1679951;1745486;1548881;0.007765;quickSort
101000;8474982464;65535;1681551;1747086;1550481;0.007759;quickSort
101100;8495192464;65535;1683151;1748686;1552081;0.008106;quickSort
101200;8515422464;65535;1684751;1750286;1553681;0.008369;quickSort
101300;8535672464;65535;1686351;1751886;1555281;0.007823;quickSort
101400;8555942464;65535;1687951;1753486;1556881;0.007794;quickSort
101500;8576232464;65535;1689551;1755086;1558481;0.007841;quickSort
101600;8596542464;65535;1691151;1756686;1560081;0.007976;quickSort
101700;8616872464;65535;1692751;1758286;1561681;0.007852;quickSort
101800;8637222464;65535;1694351;1759886;1563281;0.007811;quickSort
101900;8657592464;65535;1695951;1761486;1564881;0.007822;quickSort
102000;8677982464;65535;1697551;1763086;1566481;0.007836;quickSort
102100;8698392464;65535;1699151;1764686;1568081;0.007847;quickSort
102200;8718822464;65535;1700751;1766286;1569681;0.007874;quickSort
102300;8739272464;65535;1702351;1767886;1571281;0.007873;quickSort
102400;8759742464;65535;1703951;1769486;1572881;0.007902;quickSort
102500;8780232464;65535;1705551;1771086;1574481;0.007879;quickSort
102600;8800742464;65535;1707151;1772686;1576081;0.007870;quickSort
102700;8821272464;65535;1708751;1774286;1577681;0.007908;quickSort
102800;8841822464;65535;1710351;1775886;1579281;0.007899;quickSort
102900;8862392464;65535;1711951;1777486;1580881;0.007931;quickSort
103000;8882982464;65535;1713551;1779086;1582481;0.007901;quickSort
103100;8903592464;65535;1715151;1780686;1584081;0.007935;quickSort
103200;8924222464;65535;1716751;1782286;1585681;0.007926;quickSort
103300;8944872464;65535;1718351;1783886;1587281;0.007952;quickSort
103400;8965542464;65535;1719951;1785486;1588881;0.007956;quickSort
103500;8986232464;65535;1721551;1787086;1590481;0.007996;quickSort
103600;81006942464;65535;1723151;1788686;1592081;0.007984;quickSort
103700;81027672464;65535;1724751;1790286;1593681;0.008277;quickSort
103800;81048422464;65535;1726351;1791886;1595281;0.007999;quickSort
103900;81069192464;65535;1727951;1793486;1596881;0.008004;quickSort
104000;81089982464;65535;1729551;1795086;1598481;0.007997;quickSort
104100;81110792464;65535;1731151;1796686;1600081;0.007985;quickSort
104200;81131622464;65535;1732751;1798286;1601681;0.007999;quickSort
104300;81152472464;65535;1734351;1799886;1603281;0.008532;quickSort
104400;81173342464;65535;1735951;1801486;1604881;0.008040;quickSort
104500;81194232464;65535;1737551;1803086;1606481;0.008093;quickSort
104600;81215142464;65535;1739151;1804686;1608081;0.008027;quickSort
104700;9020320272;65535;1740751;1806286;1609681;0.008066;quickSort
104800;9041270272;65535;1742351;1807886;1611281;0.008052;quickSort
104900;9062240272;65535;1743951;1809486;1612881;0.008259;quickSort
105000;9083230272;65535;1745551;1811086;1614481;0.008042;quickSort
105100;9104240272;65535;1747151;1812686;1616081;0.008033;quickSort
105200;9125270272;65535;1748751;1814286;1617681;0.008057;quickSort
105300;9146320272;65535;1750351;1815886;1619281;0.008572;quickSort
105400;9167390272;65535;1751951;1817486;1620881;0.008058;quickSort
105500;9188480272;65535;1753551;1819086;1622481;0.008585;quickSort
105600;9209590272;65535;1755151;1820686;1624081;0.008437;quickSort
105700;9230720272;65535;1756751;1822286;1625681;0.008089;quickSort
105800;9251870272;65535;1758351;1823886;1627281;0.008098;quickSort
105900;9273040272;65535;1759951;1825486;1628881;0.008439;quickSort
106000;9294230272;65535;1761551;1827086;1630481;0.008636;quickSort
106100;9315440272;65535;1763151;1828686;1632081;0.008123;quickSort
106200;9336670272;65535;1764751;1830286;1633681;0.008121;quickSort
106300;9357920272;65535;1766351;1831886;1635281;0.008125;quickSort
106400;9379190272;65535;1767951;1833486;1636881;0.008132;quickSort
106500;9400480272;65535;1769551;1835086;1638481;0.008135;quickSort
106600;9421790272;65535;1771151;1836686;1640081;0.008117;quickSort
106700;9443120272;65535;1772751;1838286;1641681;0.008277;quickSort
106800;9464470272;65535;1774351;1839886;1643281;0.008816;quickSort
106900;9485840272;65535;1775951;1841486;1644881;0.008127;quickSort
107000;9507230272;65535;1777551;1843086;1646481;0.008145;quickSort
107100;9528640272;65535;1779151;1844686;1648081;0.008174;quickSort
107200;9550070272;65535;1780751;1846286;1649681;0.008160;quickSort
107300;9571520272;65535;1782351;1847886;1651281;0.008191;quickSort
107400;9592990272;65535;1783951;1849486;1652881;0.008661;quickSort
107500;9614480272;65535;1785551;1851086;1654481;0.008172;quickSort
107600;9635990272;65535;1787151;1852686;1656081;0.008708;quickSort
107700;9657520272;65535;1788751;1854286;1657681;0.008181;quickSort
107800;9679070272;65535;1790351;1855886;1659281;0.008191;quickSort
107900;9700640272;65535;1791951;1857486;1660881;0.008207;quickSort
108000;9722230272;65535;1793551;1859086;1662481;0.008200;quickSort
108100;9743840272;65535;1795151;1860686;1664081;0.008204;quickSort
108200;9765470272;65535;1796751;1862286;1665681;0.008060;quickSort
108300;9787120272;65535;1798351;1863886;1667281;0.008042;quickSort
108400;9808790272;65535;1799951;1865486;1668881;0.008996;quickSort
108500;9830480272;65535;1801551;1867086;1670481;0.009227;quickSort
108600;9852190272;65535;1803151;1868686;1672081;0.008234;quickSort
108700;9873920272;65535;1804751;1870286;1673681;0.008316;quickSort
108800;9895670272;65535;1806351;1871886;1675281;0.008786;quickSort
108900;9917440272;65535;1807951;1873486;1676881;0.008355;quickSort
109000;9939230272;65535;1809551;1875086;1678481;0.008276;quickSort
109100;9961040272;65535;1811151;1876686;1680081;0.008272;quickSort
109200;9982870272;65535;1812751;1878286;1681681;0.008518;quickSort
109300;91004720272;65535;1814351;1879886;1683281;0.008362;quickSort
109400;91026590272;65535;1815951;1881486;1684881;0.008273;quickSort
109600;91070390272;65535;1819151;1884686;1688081;0.008332;quickSort
109700;91092320272;65535;1820751;1886286;1689681;0.008389;quickSort
109800;91114270272;65535;1822351;1887886;1691281;0.008744;quickSort
109900;91136240272;65535;1823951;1889486;1692881;0.008870;quickSort
110000;91158230272;65535;1825551;1891086;1694481;0.008978;quickSort
110100;91180240272;65535;1827151;1892686;1696081;0.008366;quickSort
110200;91202270272;65535;1828751;1894286;1697681;0.009261;quickSort
110300;10008568080;65535;1830351;1895886;1699281;0.009262;quickSort
110400;10030638080;65535;1831951;1897486;1700881;0.008452;quickSort
110500;10052728080;65535;1833551;1899086;1702481;0.008167;quickSort
110600;10074838080;65535;1835151;1900686;1704081;0.008185;quickSort
110700;10096968080;65535;1836751;1902286;1705681;0.008789;quickSort
110800;10119118080;65535;1838351;1903886;1707281;0.008402;quickSort
110900;10141288080;65535;1839951;1905486;1708881;0.008468;quickSort
111000;10163478080;65535;1841551;1907086;1710481;0.008393;quickSort
111100;10185688080;65535;1843151;1908686;1712081;0.008375;quickSort
111200;10207918080;65535;1844751;1910286;1713681;0.008826;quickSort
111300;10230168080;65535;1846351;1911886;1715281;0.008449;quickSort
111400;10252438080;65535;1847951;1913486;1716881;0.008382;quickSort
111500;10274728080;65535;1849551;1915086;1718481;0.008398;quickSort
111600;10297038080;65535;1851151;1916686;1720081;0.008400;quickSort
111700;10319368080;65535;1852751;1918286;1721681;0.008404;quickSort
111800;10341718080;65535;1854351;1919886;1723281;0.008535;quickSort
111900;10364088080;65535;1855951;1921486;1724881;0.008433;quickSort
112000;10386478080;65535;1857551;1923086;1726481;0.008423;quickSort
112100;10408888080;65535;1859151;1924686;1728081;0.008436;quickSort
112200;10431318080;65535;1860751;1926286;1729681;0.008422;quickSort
112300;10453768080;65535;1862351;1927886;1731281;0.008481;quickSort
112400;10476238080;65535;1863951;1929486;1732881;0.008414;quickSort
112500;10498728080;65535;1865551;1931086;1734481;0.008445;quickSort
112600;10521238080;65535;1867151;1932686;1736081;0.008462;quickSort
112700;10543768080;65535;1868751;1934286;1737681;0.008256;quickSort
112800;10566318080;65535;1870351;1935886;1739281;0.008291;quickSort
112900;10588888080;65535;1871951;1937486;1740881;0.008438;quickSort
113000;10611478080;65535;1873551;1939086;1742481;0.008457;quickSort
113100;10634088080;65535;1875151;1940686;1744081;0.008474;quickSort
113200;10656718080;65535;1876751;1942286;1745681;0.009149;quickSort
113300;10679368080;65535;1878351;1943886;1747281;0.008786;quickSort
113400;10702038080;65535;1879951;1945486;1748881;0.008775;quickSort
113500;10724728080;65535;1881551;1947086;1750481;0.008497;quickSort
113600;10747438080;65535;1883151;1948686;1752081;0.008475;quickSort
113700;10770168080;65535;1884751;1950286;1753681;0.008469;quickSort
113800;10792918080;65535;1886351;1951886;1755281;0.008455;quickSort
113900;10815688080;65535;1887951;1953486;1756881;0.008268;quickSort
114000;10838478080;65535;1889551;1955086;1758481;0.008760;quickSort
114100;10861288080;65535;1891151;1956686;1760081;0.008519;quickSort
114200;10884118080;65535;1892751;1958286;1761681;0.008523;quickSort
114300;10906968080;65535;1894351;1959886;1763281;0.008545;quickSort
114400;10929838080;65535;1895951;1961486;1764881;0.008515;quickSort
114500;10952728080;65535;1897551;1963086;1766481;0.008528;quickSort
114600;10975638080;65535;1899151;1964686;1768081;0.008554;quickSort
114700;10998568080;65535;1900751;1966286;1769681;0.008572;quickSort
114900;101044488080;65535;1903951;1969486;1772881;0.008612;quickSort
115000;101067478080;65535;1905551;1971086;1774481;0.009062;quickSort
115100;101090488080;65535;1907151;1972686;1776081;0.009619;quickSort
115200;101113518080;65535;1908751;1974286;1777681;0.009328;quickSort
115300;101136568080;65535;1910351;1975886;1779281;0.008690;quickSort
115400;101159638080;65535;1911951;1977486;1780881;0.008489;quickSort
115500;101182728080;65535;1913551;1979086;1782481;0.008756;quickSort
115600;101205838080;65535;1915151;1980686;1784081;0.008685;quickSort
115700;11013215888;65535;1916751;1982286;1785681;0.009337;quickSort
115800;11036365888;65535;1918351;1983886;1787281;0.008620;quickSort
115900;11059535888;65535;1919951;1985486;1788881;0.008604;quickSort
116000;11082725888;65535;1921551;1987086;1790481;0.008610;quickSort
116100;11105935888;65535;1923151;1988686;1792081;0.008626;quickSort
116200;11129165888;65535;1924751;1990286;1793681;0.008623;quickSort
116300;11152415888;65535;1926351;1991886;1795281;0.008624;quickSort
116400;11175685888;65535;1927951;1993486;1796881;0.008850;quickSort
116500;11198975888;65535;1929551;1995086;1798481;0.008620;quickSort
116600;11222285888;65535;1931151;1996686;1800081;0.008648;quickSort
116700;11245615888;65535;1932751;1998286;1801681;0.008674;quickSort
116800;11268965888;65535;1934351;1999886;1803281;0.008662;quickSort
116900;11292335888;65535;1935951;2001486;1804881;0.008671;quickSort
117000;11315725888;65535;1937551;2003086;1806481;0.008688;quickSort
117100;11339135888;65535;1939151;2004686;1808081;0.008690;quickSort
117200;11362565888;65535;1940751;2006286;1809681;0.008710;quickSort
117300;11386015888;65535;1942351;2007886;1811281;0.008688;quickSort
117400;11409485888;65535;1943951;2009486;1812881;0.008692;quickSort
117500;11432975888;65535;1945551;2011086;1814481;0.008705;quickSort
117600;11456485888;65535;1947151;2012686;1816081;0.008717;quickSort
117700;11480015888;65535;1948751;2014286;1817681;0.008726;quickSort
117800;11503565888;65535;1950351;2015886;1819281;0.008741;quickSort
117900;11527135888;65535;1951951;2017486;1820881;0.008734;quickSort
118000;11550725888;65535;1953551;2019086;1822481;0.008809;quickSort
118100;11574335888;65535;1955151;2020686;1824081;0.008742;quickSort
118200;11597965888;65535;1956751;2022286;1825681;0.009624;quickSort
118300;11621615888;65535;1958351;2023886;1827281;0.008761;quickSort
118400;11645285888;65535;1959951;2025486;1828881;0.008785;quickSort
118500;11668975888;65535;1961551;2027086;1830481;0.008774;quickSort
118600;11692685888;65535;1963151;2028686;1832081;0.008777;quickSort
118700;11716415888;65535;1964751;2030286;1833681;0.008799;quickSort
118800;11740165888;65535;1966351;2031886;1835281;0.008806;quickSort
118900;11763935888;65535;1967951;2033486;1836881;0.008795;quickSort
119000;11787725888;65535;1969551;2035086;1838481;0.009396;quickSort
119100;11811535888;65535;1971151;2036686;1840081;0.008809;quickSort
119200;11835365888;65535;1972751;2038286;1841681;0.009308;quickSort
119300;11859215888;65535;1974351;2039886;1843281;0.008835;quickSort
119400;11883085888;65535;1975951;2041486;1844881;0.008837;quickSort
119500;11906975888;65535;1977551;2043086;1846481;0.008827;quickSort
119600;11930885888;65535;1979151;2044686;1848081;0.008872;quickSort
119700;11954815888;65535;1980751;2046286;1849681;0.008855;quickSort
119800;11978765888;65535;1982351;2047886;1851281;0.009354;quickSort
119900;111002735888;65535;1983951;2049486;1852881;0.008839;quickSort
120000;111026725888;65535;1985551;2051086;1854481;0.008832;quickSort
120100;111050735888;65535;1987151;2052686;1856081;0.008730;quickSort
120200;111074765888;65535;1988751;2054286;1857681;0.008650;quickSort
120300;111098815888;65535;1990351;2055886;1859281;0.008646;quickSort
120400;111122885888;65535;1991951;2057486;1860881;0.008670;quickSort
120500;111146975888;65535;1993551;2059086;1862481;0.008661;quickSort
120600;111171085888;65535;1995151;2060686;1864081;0.008906;quickSort
120700;111195215888;65535;1996751;2062286;1865681;0.008915;quickSort
120800;12003613696;65535;1998351;2063886;1867281;0.008901;quickSort
120900;12027783696;65535;1999951;2065486;1868881;0.008915;quickSort
121000;12051973696;65535;2001551;2067086;1870481;0.009381;quickSort
121100;12076183696;65535;2003151;2068686;1872081;0.008989;quickSort
121200;12100413696;65535;2004751;2070286;1873681;0.009321;quickSort
121300;12124663696;65535;2006351;2071886;1875281;0.008851;quickSort
121400;12148933696;65535;2007951;2073486;1876881;0.008946;quickSort
121500;12173223696;65535;2009551;2075086;1878481;0.009007;quickSort
121600;12197533696;65535;2011151;2076686;1880081;0.009316;quickSort
121700;12221863696;65535;2012751;2078286;1881681;0.008954;quickSort
121800;12246213696;65535;2014351;2079886;1883281;0.008967;quickSort
121900;12270583696;65535;2015951;2081486;1884881;0.008957;quickSort
122000;12294973696;65535;2017551;2083086;1886481;0.008955;quickSort
122100;12319383696;65535;2019151;2084686;1888081;0.008983;quickSort
122200;12343813696;65535;2020751;2086286;1889681;0.009392;quickSort
122300;12368263696;65535;2022351;2087886;1891281;0.008964;quickSort
122400;12392733696;65535;2023951;2089486;1892881;0.009007;quickSort
122500;12417223696;65535;2025551;2091086;1894481;0.009001;quickSort
122600;12441733696;65535;2027151;2092686;1896081;0.008985;quickSort
122700;12466263696;65535;2028751;2094286;1897681;0.008994;quickSort
122800;12490813696;65535;2030351;2095886;1899281;0.009024;quickSort
122900;12515383696;65535;2031951;2097486;1900881;0.009022;quickSort
123000;12539973696;65535;2033551;2099086;1902481;0.008973;quickSort
123100;12564583696;65535;2035151;2100686;1904081;0.009055;quickSort
123200;12589213696;65535;2036751;2102286;1905681;0.009042;quickSort
123300;12613863696;65535;2038351;2103886;1907281;0.009514;quickSort
123400;12638533696;65535;2039951;2105486;1908881;0.009127;quickSort
123500;12663223696;65535;2041551;2107086;1910481;0.009100;quickSort
123600;12687933696;65535;2043151;2108686;1912081;0.009093;quickSort
123700;12712663696;65535;2044751;2110286;1913681;0.009142;quickSort
123800;12737413696;65535;2046351;2111886;1915281;0.009473;quickSort
123900;12762183696;65535;2047951;2113486;1916881;0.009063;quickSort
124000;12786973696;65535;2049551;2115086;1918481;0.009081;quickSort
124100;12811783696;65535;2051151;2116686;1920081;0.009077;quickSort
124200;12836613696;65535;2052751;2118286;1921681;0.009097;quickSort
124300;12861463696;65535;2054351;2119886;1923281;0.009092;quickSort
124400;12886333696;65535;2055951;2121486;1924881;0.009128;quickSort
124500;12911223696;65535;2057551;2123086;1926481;0.009141;quickSort
124600;12936133696;65535;2059151;2124686;1928081;0.009106;quickSort
124700;12961063696;65535;2060751;2126286;1929681;0.009137;quickSort
124800;12986013696;65535;2062351;2127886;1931281;0.009146;quickSort
124900;121010983696;65535;2063951;2129486;1932881;0.009142;quickSort
125000;121035973696;65535;2065551;2131086;1934481;0.009147;quickSort
125100;121060983696;65535;2067151;2132686;1936081;0.009225;quickSort
125200;121086013696;65535;2068751;2134286;1937681;0.009268;quickSort
125300;121111063696;65535;2070351;2135886;1939281;0.009421;quickSort
125400;121136133696;65535;2071951;2137486;1940881;0.009750;quickSort
125500;121161223696;65535;2073551;2139086;1942481;0.009833;quickSort
125600;121186333696;65535;2075151;2140686;1944081;0.009031;quickSort
125700;121211463696;65535;2076751;2142286;1945681;0.008984;quickSort
125800;13020861504;65535;2078351;2143886;1947281;0.009818;quickSort
125900;13046031504;65535;2079951;2145486;1948881;0.009314;quickSort
126000;13071221504;65535;2081551;2147086;1950481;0.008998;quickSort
126100;13096431504;65535;2083151;2148686;1952081;0.008994;quickSort
126200;13121661504;65535;2084751;2150286;1953681;0.009268;quickSort
126300;13146911504;65535;2086351;2151886;1955281;0.009277;quickSort
126400;13172181504;65535;2087951;2153486;1956881;0.009241;quickSort
126500;13197471504;65535;2089551;2155086;1958481;0.009242;quickSort
126600;13222781504;65535;2091151;2156686;1960081;0.009285;quickSort
126700;13248111504;65535;2092751;2158286;1961681;0.009258;quickSort
126800;13273461504;65535;2094351;2159886;1963281;0.009288;quickSort
126900;13298831504;65535;2095951;2161486;1964881;0.009312;quickSort
127000;13324221504;65535;2097551;2163086;1966481;0.009291;quickSort
127100;13349631504;65535;2099151;2164686;1968081;0.009284;quickSort
127200;13375061504;65535;2100751;2166286;1969681;0.009791;quickSort
127300;13400511504;65535;2102351;2167886;1971281;0.009316;quickSort
127400;13425981504;65535;2103951;2169486;1972881;0.009302;quickSort
127500;13451471504;65535;2105551;2171086;1974481;0.009344;quickSort
127600;13476981504;65535;2107151;2172686;1976081;0.009761;quickSort
127700;13502511504;65535;2108751;2174286;1977681;0.009331;quickSort
127800;13528061504;65535;2110351;2175886;1979281;0.009356;quickSort
127900;13553631504;65535;2111951;2177486;1980881;0.009877;quickSort
128000;13579221504;65535;2113551;2179086;1982481;0.009166;quickSort
128100;13604831504;65535;2115151;2180686;1984081;0.009767;quickSort
128200;13630461504;65535;2116751;2182286;1985681;0.009399;quickSort
128300;13656111504;65535;2118351;2183886;1987281;0.009340;quickSort
128400;13681781504;65535;2119951;2185486;1988881;0.009419;quickSort
128500;13707471504;65535;2121551;2187086;1990481;0.009798;quickSort
128600;13733181504;65535;2123151;2188686;1992081;0.009374;quickSort
128700;13758911504;65535;2124751;2190286;1993681;0.009373;quickSort
128800;13784661504;65535;2126351;2191886;1995281;0.009400;quickSort
128900;13810431504;65535;2127951;2193486;1996881;0.009399;quickSort
129000;13836221504;65535;2129551;2195086;1998481;0.009442;quickSort
129100;13862031504;65535;2131151;2196686;2000081;0.009859;quickSort
129200;13887861504;65535;2132751;2198286;2001681;0.009592;quickSort
129300;13913711504;65535;2134351;2199886;2003281;0.009538;quickSort
129400;13939581504;65535;2135951;2201486;2004881;0.009514;quickSort
129500;13965471504;65535;2137551;2203086;2006481;0.010422;quickSort
129600;13991381504;65535;2139151;2204686;2008081;0.009460;quickSort
129700;131017311504;65535;2140751;2206286;2009681;0.009430;quickSort
129900;131069231504;65535;2143951;2209486;2012881;0.009406;quickSort
130000;131095221504;65535;2145551;2211086;2014481;0.009443;quickSort
130100;131121231504;65535;2147151;2212686;2016081;0.009471;quickSort
130200;131147261504;65535;2148751;2214286;2017681;0.009433;quickSort
130300;131173311504;65535;2150351;2215886;2019281;0.009461;quickSort
130400;131199381504;65535;2151951;2217486;2020881;0.009481;quickSort
130500;14009719312;65535;2153551;2219086;2022481;0.009452;quickSort
130600;14035829312;65535;2155151;2220686;2024081;0.009493;quickSort
130700;14061959312;65535;2156751;2222286;2025681;0.009968;quickSort
130800;14088109312;65535;2158351;2223886;2027281;0.009497;quickSort
130900;14114279312;65535;2159951;2225486;2028881;0.009490;quickSort
131000;14140469312;65535;2161551;2227086;2030481;0.009535;quickSort
131100;14166679312;65564;2163267;2228831;2032139;0.009527;quickSort
131200;14192909312;65664;2165267;2230931;2033939;0.009597;quickSort
131300;14219159312;65764;2167267;2233031;2035739;0.009517;quickSort
131400;14245429312;65864;2169267;2235131;2037539;0.009531;quickSort
131500;14271719312;65964;2171267;2237231;2039339;0.009575;quickSort
131600;14298029312;66064;2173267;2239331;2041139;0.009528;quickSort
131700;14324359312;66164;2175267;2241431;2042939;0.009560;quickSort
131800;14350709312;66264;2177267;2243531;2044739;0.009601;quickSort
131900;14377079312;66364;2179267;2245631;2046539;0.009636;quickSort
132000;14403469312;66464;2181267;2247731;2048339;0.009576;quickSort
132100;14429879312;66564;2183267;2249831;2050139;0.009629;quickSort
132200;14456309312;66664;2185267;2251931;2051939;0.009636;quickSort
132300;14482759312;66764;2187267;2254031;2053739;0.009624;quickSort
132400;14509229312;66864;2189267;2256131;2055539;0.009643;quickSort
132500;14535719312;66964;2191267;2258231;2057339;0.009667;quickSort
132600;14562229312;67064;2193267;2260331;2059139;0.009680;quickSort
132700;14588759312;67164;2195267;2262431;2060939;0.009687;quickSort
132800;14615309312;67264;2197267;2264531;2062739;0.011304;quickSort
132900;14641879312;67364;2199267;2266631;2064539;0.009738;quickSort
133000;14668469312;67464;2201267;2268731;2066339;0.009751;quickSort
133100;14695079312;67564;2203267;2270831;2068139;0.009764;quickSort
133200;14721709312;67664;2205267;2272931;2069939;0.009753;quickSort
133300;14748359312;67764;2207267;2275031;2071739;0.009799;quickSort
133400;14775029312;67864;2209267;2277131;2073539;0.010210;quickSort
133500;14801719312;67964;2211267;2279231;2075339;0.010141;quickSort
133600;14828429312;68064;2213267;2281331;2077139;0.009834;quickSort
133700;14855159312;68164;2215267;2283431;2078939;0.009802;quickSort
133800;14881909312;68264;2217267;2285531;2080739;0.009854;quickSort
133900;14908679312;68364;2219267;2287631;2082539;0.009831;quickSort
134000;14935469312;68464;2221267;2289731;2084339;0.009825;quickSort
134100;14962279312;68564;2223267;2291831;2086139;0.009872;quickSort
134200;14989109312;68664;2225267;2293931;2087939;0.009918;quickSort
134300;141015959312;68764;2227267;2296031;2089739;0.009881;quickSort
134400;141042829312;68864;2229267;2298131;2091539;0.009871;quickSort
134500;141069719312;68964;2231267;2300231;2093339;0.009918;quickSort
134700;141123559312;69164;2235267;2304431;2096939;0.009914;quickSort
134800;141150509312;69264;2237267;2306531;2098739;0.010050;quickSort
134900;141177479312;69364;2239267;2308631;2100539;0.009962;quickSort
135000;141204469312;69464;2241267;2310731;2102339;0.009929;quickSort
135100;15015727120;69564;2243267;2312831;2104139;0.009966;quickSort
135200;15042757120;69664;2245267;2314931;2105939;0.010198;quickSort
135300;15069807120;69764;2247267;2317031;2107739;0.009999;quickSort
135400;15096877120;69864;2249267;2319131;2109539;0.010026;quickSort
135500;15123967120;69964;2251267;2321231;2111339;0.010014;quickSort
135600;15151077120;70064;2253267;2323331;2113139;0.010070;quickSort
135700;15178207120;70164;2255267;2325431;2114939;0.010060;quickSort
135800;15205357120;70264;2257267;2327531;2116739;0.010041;quickSort
135900;15232527120;70364;2259267;2329631;2118539;0.010038;quickSort
136000;15259717120;70464;2261267;2331731;2120339;0.010061;quickSort
136100;15286927120;70564;2263267;2333831;2122139;0.010084;quickSort
136200;15314157120;70664;2265267;2335931;2123939;0.010273;quickSort
136300;15341407120;70764;2267267;2338031;2125739;0.010057;quickSort
136400;15368677120;70864;2269267;2340131;2127539;0.010554;quickSort
136500;15395967120;70964;2271267;2342231;2129339;0.010122;quickSort
136600;15423277120;71064;2273267;2344331;2131139;0.010139;quickSort
136700;15450607120;71164;2275267;2346431;2132939;0.010193;quickSort
136800;15477957120;71264;2277267;2348531;2134739;0.010487;quickSort
136900;15505327120;71364;2279267;2350631;2136539;0.010411;quickSort
137000;15532717120;71464;2281267;2352731;2138339;0.010191;quickSort
137100;15560127120;71564;2283267;2354831;2140139;0.010140;quickSort
137200;15587557120;71664;2285267;2356931;2141939;0.009910;quickSort
137300;15615007120;71764;2287267;2359031;2143739;0.010047;quickSort
137400;15642477120;71864;2289267;2361131;2145539;0.010198;quickSort
137500;15669967120;71964;2291267;2363231;2147339;0.010208;quickSort
137600;15697477120;72064;2293267;2365331;2149139;0.010207;quickSort
137700;15725007120;72164;2295267;2367431;2150939;0.011577;quickSort
137800;15752557120;72264;2297267;2369531;2152739;0.011409;quickSort
137900;15780127120;72364;2299267;2371631;2154539;0.010046;quickSort
138000;15807717120;72464;2301267;2373731;2156339;0.010005;quickSort
138100;15835327120;72564;2303267;2375831;2158139;0.010777;quickSort
138200;15862957120;72664;2305267;2377931;2159939;0.010311;quickSort
138300;15890607120;72764;2307267;2380031;2161739;0.010290;quickSort
138400;15918277120;72864;2309267;2382131;2163539;0.010293;quickSort
138500;15945967120;72964;2311267;2384231;2165339;0.010297;quickSort
138600;15973677120;73064;2313267;2386331;2167139;0.010320;quickSort
138700;151001407120;73164;2315267;2388431;2168939;0.010448;quickSort
138800;151029157120;73264;2317267;2390531;2170739;0.010390;quickSort
138900;151056927120;73364;2319267;2392631;2172539;0.010886;quickSort
139000;151084717120;73464;2321267;2394731;2174339;0.010364;quickSort
139100;151112527120;73564;2323267;2396831;2176139;0.010378;quickSort
139200;151140357120;73664;2325267;2398931;2177939;0.010400;quickSort
139300;151168207120;73764;2327267;2401031;2179739;0.010407;quickSort
139400;151196077120;73864;2329267;2403131;2181539;0.010424;quickSort
139500;16008214928;73964;2331267;2405231;2183339;0.010937;quickSort
139600;16036124928;74064;2333267;2407331;2185139;0.010769;quickSort
139700;16064054928;74164;2335267;2409431;2186939;0.010403;quickSort
139800;16092004928;74264;2337267;2411531;2188739;0.010407;quickSort
139900;16119974928;74364;2339267;2413631;2190539;0.010415;quickSort
140000;16147964928;74464;2341267;2415731;2192339;0.010448;quickSort
140100;16175974928;74564;2343267;2417831;2194139;0.012036;quickSort
140200;16204004928;74664;2345267;2419931;2195939;0.010629;quickSort
140300;16232054928;74764;2347267;2422031;2197739;0.010485;quickSort
140400;16260124928;74864;2349267;2424131;2199539;0.010445;quickSort
140500;16288214928;74964;2351267;2426231;2201339;0.010513;quickSort
140600;16316324928;75064;2353267;2428331;2203139;0.011589;quickSort
140700;16344454928;75164;2355267;2430431;2204939;0.010480;quickSort
140800;16372604928;75264;2357267;2432531;2206739;0.010606;quickSort
140900;16400774928;75364;2359267;2434631;2208539;0.011028;quickSort
141000;16428964928;75464;2361267;2436731;2210339;0.010676;quickSort
141100;16457174928;75564;2363267;2438831;2212139;0.010547;quickSort
141200;16485404928;75664;2365267;2440931;2213939;0.010572;quickSort
141300;16513654928;75764;2367267;2443031;2215739;0.010561;quickSort
141400;16541924928;75864;2369267;2445131;2217539;0.012133;quickSort
141500;16570214928;75964;2371267;2447231;2219339;0.010580;quickSort
141600;16598524928;76064;2373267;2449331;2221139;0.010589;quickSort
141700;16626854928;76164;2375267;2451431;2222939;0.010587;quickSort
141800;16655204928;76264;2377267;2453531;2224739;0.010601;quickSort
141900;16683574928;76364;2379267;2455631;2226539;0.010606;quickSort
142000;16711964928;76464;2381267;2457731;2228339;0.010620;quickSort
142100;16740374928;76564;2383267;2459831;2230139;0.010652;quickSort
142200;16768804928;76664;2385267;2461931;2231939;0.011051;quickSort
142300;16797254928;76764;2387267;2464031;2233739;0.010688;quickSort
142400;16825724928;76864;2389267;2466131;2235539;0.010645;quickSort
142500;16854214928;76964;2391267;2468231;2237339;0.011143;quickSort
142600;16882724928;77064;2393267;2470331;2239139;0.010689;quickSort
142700;16911254928;77164;2395267;2472431;2240939;0.010699;quickSort
142800;16939804928;77264;2397267;2474531;2242739;0.011119;quickSort
142900;16968374928;77364;2399267;2476631;2244539;0.011472;quickSort
143000;16996964928;77464;2401267;2478731;2246339;0.011246;quickSort
143100;161025574928;77564;2403267;2480831;2248139;0.010903;quickSort
143200;161054204928;77664;2405267;2482931;2249939;0.010751;quickSort
143300;161082854928;77764;2407267;2485031;2251739;0.010769;quickSort
143400;161111524928;77864;2409267;2487131;2253539;0.010789;quickSort
143500;161140214928;77964;2411267;2489231;2255339;0.010783;quickSort
143600;161168924928;78064;2413267;2491331;2257139;0.010777;quickSort
143700;161197654928;78164;2415267;2493431;2258939;0.010807;quickSort
143800;17010652736;78264;2417267;2495531;2260739;0.010815;quickSort
143900;17039422736;78364;2419267;2497631;2262539;0.010800;quickSort
144000;17068212736;78464;2421267;2499731;2264339;0.010818;quickSort
144100;17097022736;78564;2423267;2501831;2266139;0.010822;quickSort
144200;17125852736;78664;2425267;2503931;2267939;0.010857;quickSort
144300;17154702736;78764;2427267;2506031;2269739;0.010868;quickSort
144400;17183572736;78864;2429267;2508131;2271539;0.010848;quickSort
144500;17212462736;78964;2431267;2510231;2273339;0.010839;quickSort
144600;17241372736;79064;2433267;2512331;2275139;0.010891;quickSort
144700;17270302736;79164;2435267;2514431;2276939;0.010864;quickSort
144800;17299252736;79264;2437267;2516531;2278739;0.011111;quickSort
144900;17328222736;79364;2439267;2518631;2280539;0.010866;quickSort
145000;17357212736;79464;2441267;2520731;2282339;0.010614;quickSort
145100;17386222736;79564;2443267;2522831;2284139;0.010764;quickSort
145200;17415252736;79664;2445267;2524931;2285939;0.010641;quickSort
145300;17444302736;79764;2447267;2527031;2287739;0.010907;quickSort
145400;17473372736;79864;2449267;2529131;2289539;0.010902;quickSort
145500;17502462736;79964;2451267;2531231;2291339;0.010935;quickSort
145600;17531572736;80064;2453267;2533331;2293139;0.011432;quickSort
145700;17560702736;80164;2455267;2535431;2294939;0.011359;quickSort
145800;17589852736;80264;2457267;2537531;2296739;0.011010;quickSort
145900;17619022736;80364;2459267;2539631;2298539;0.010723;quickSort
146000;17648212736;80464;2461267;2541731;2300339;0.010682;quickSort
146100;17677422736;80564;2463267;2543831;2302139;0.010702;quickSort
146200;17706652736;80664;2465267;2545931;2303939;0.010719;quickSort
146300;17735902736;80764;2467267;2548031;2305739;0.010719;quickSort
146400;17765172736;80864;2469267;2550131;2307539;0.011006;quickSort
146500;17794462736;80964;2471267;2552231;2309339;0.010981;quickSort
146600;17823772736;81064;2473267;2554331;2311139;0.012285;quickSort
146700;17853102736;81164;2475267;2556431;2312939;0.011439;quickSort
146800;17882452736;81264;2477267;2558531;2314739;0.011052;quickSort
146900;17911822736;81364;2479267;2560631;2316539;0.011471;quickSort
147000;17941212736;81464;2481267;2562731;2318339;0.011048;quickSort
147100;17970622736;81564;2483267;2564831;2320139;0.011591;quickSort
147200;171000052736;81664;2485267;2566931;2321939;0.011046;quickSort
147300;171029502736;81764;2487267;2569031;2323739;0.011072;quickSort
147400;171058972736;81864;2489267;2571131;2325539;0.011147;quickSort
147500;171088462736;81964;2491267;2573231;2327339;0.011562;quickSort
147600;171117972736;82064;2493267;2575331;2329139;0.011671;quickSort
147700;171147502736;82164;2495267;2577431;2330939;0.011139;quickSort
147800;171177052736;82264;2497267;2579531;2332739;0.011110;quickSort
147900;171206622736;82364;2499267;2581631;2334539;0.011823;quickSort
148000;18020460544;82464;2501267;2583731;2336339;0.011689;quickSort
148100;18050070544;82564;2503267;2585831;2338139;0.011448;quickSort
148200;18079700544;82664;2505267;2587931;2339939;0.011173;quickSort
148300;18109350544;82764;2507267;2590031;2341739;0.011194;quickSort
148400;18139020544;82864;2509267;2592131;2343539;0.011158;quickSort
148500;18168710544;82964;2511267;2594231;2345339;0.011174;quickSort
148600;18198420544;83064;2513267;2596331;2347139;0.011202;quickSort
148700;18228150544;83164;2515267;2598431;2348939;0.011194;quickSort
148800;18257900544;83264;2517267;2600531;2350739;0.011238;quickSort
148900;18287670544;83364;2519267;2602631;2352539;0.011222;quickSort
149000;18317460544;83464;2521267;2604731;2354339;0.011351;quickSort
149100;18347270544;83564;2523267;2606831;2356139;0.011256;quickSort
149200;18377100544;83664;2525267;2608931;2357939;0.011754;quickSort
149300;18406950544;83764;2527267;2611031;2359739;0.011273;quickSort
149400;18436820544;83864;2529267;2613131;2361539;0.011283;quickSort
149500;18466710544;83964;2531267;2615231;2363339;0.011284;quickSort
149600;18496620544;84064;2533267;2617331;2365139;0.011300;quickSort
149700;18526550544;84164;2535267;2619431;2366939;0.011345;quickSort
149800;18556500544;84264;2537267;2621531;2368739;0.011329;quickSort
149900;18586470544;84364;2539267;2623631;2370539;0.011315;quickSort
150000;18616460544;84464;2541267;2625731;2372339;0.011521;quickSort
150100;18646470544;84564;2543267;2627831;2374139;0.011352;quickSort
150200;18676500544;84664;2545267;2629931;2375939;0.011384;quickSort
150300;18706550544;84764;2547267;2632031;2377739;0.011365;quickSort
150400;18736620544;84864;2549267;2634131;2379539;0.011379;quickSort
150500;18766710544;84964;2551267;2636231;2381339;0.011381;quickSort
150600;18796820544;85064;2553267;2638331;2383139;0.011404;quickSort
150700;18826950544;85164;2555267;2640431;2384939;0.011417;quickSort
150800;18857100544;85264;2557267;2642531;2386739;0.011433;quickSort
150900;18887270544;85364;2559267;2644631;2388539;0.011529;quickSort
151000;18917460544;85464;2561267;2646731;2390339;0.011418;quickSort
151100;18947670544;85564;2563267;2648831;2392139;0.011443;quickSort
151200;18977900544;85664;2565267;2650931;2393939;0.011461;quickSort
151300;181008150544;85764;2567267;2653031;2395739;0.011518;quickSort
151400;181038420544;85864;2569267;2655131;2397539;0.011516;quickSort
151500;181068710544;85964;2571267;2657231;2399339;0.011525;quickSort
151600;181099020544;86064;2573267;2659331;2401139;0.011522;quickSort
151700;181129350544;86164;2575267;2661431;2402939;0.011503;quickSort
151800;181159700544;86264;2577267;2663531;2404739;0.011445;quickSort
151900;181190070544;86364;2579267;2665631;2406539;0.011223;quickSort
152000;19004708352;86464;2581267;2667731;2408339;0.011236;quickSort
152100;19035118352;86564;2583267;2669831;2410139;0.011266;quickSort
152200;19065548352;86664;2585267;2671931;2411939;0.011559;quickSort
152300;19095998352;86764;2587267;2674031;2413739;0.011577;quickSort
152400;19126468352;86864;2589267;2676131;2415539;0.011632;quickSort
152500;19156958352;86964;2591267;2678231;2417339;0.011590;quickSort
152600;19187468352;87064;2593267;2680331;2419139;0.011577;quickSort
152700;19217998352;87164;2595267;2682431;2420939;0.011644;quickSort
152800;19248548352;87264;2597267;2684531;2422739;0.011607;quickSort
152900;19279118352;87364;2599267;2686631;2424539;0.011580;quickSort
153000;19309708352;87464;2601267;2688731;2426339;0.011624;quickSort
153100;19340318352;87564;2603267;2690831;2428139;0.011687;quickSort
153200;19370948352;87664;2605267;2692931;2429939;0.011811;quickSort
153300;19401598352;87764;2607267;2695031;2431739;0.011731;quickSort
153400;19432268352;87864;2609267;2697131;2433539;0.012762;quickSort
153500;19462958352;87964;2611267;2699231;2435339;0.011859;quickSort
153600;19493668352;88064;2613267;2701331;2437139;0.012386;quickSort
153700;19524398352;88164;2615267;2703431;2438939;0.012146;quickSort
153800;19555148352;88264;2617267;2705531;2440739;0.011895;quickSort
153900;19585918352;88364;2619267;2707631;2442539;0.012363;quickSort
154000;19616708352;88464;2621267;2709731;2444339;0.011801;quickSort
154100;19647518352;88564;2623267;2711831;2446139;0.011432;quickSort
154200;19678348352;88664;2625267;2713931;2447939;0.013028;quickSort
154300;19709198352;88764;2627267;2716031;2449739;0.011760;quickSort
154400;19740068352;88864;2629267;2718131;2451539;0.011946;quickSort
154500;19770958352;88964;2631267;2720231;2453339;0.012237;quickSort
154600;19801868352;89064;2633267;2722331;2455139;0.011888;quickSort
154700;19832798352;89164;2635267;2724431;2456939;0.013199;quickSort
154800;19863748352;89264;2637267;2726531;2458739;0.011837;quickSort
154900;19894718352;89364;2639267;2728631;2460539;0.011797;quickSort
155000;19925708352;89464;2641267;2730731;2462339;0.011840;quickSort
155100;19956718352;89564;2643267;2732831;2464139;0.011602;quickSort
155200;19987748352;89664;2645267;2734931;2465939;0.011854;quickSort
155300;191018798352;89764;2647267;2737031;2467739;0.011849;quickSort
155400;191049868352;89864;2649267;2739131;2469539;0.011872;quickSort
155500;191080958352;89964;2651267;2741231;2471339;0.013217;quickSort
155600;191112068352;90064;2653267;2743331;2473139;0.012757;quickSort
155700;191143198352;90164;2655267;2745431;2474939;0.012070;quickSort
155800;191174348352;90264;2657267;2747531;2476739;0.012364;quickSort
155900;191205518352;90364;2659267;2749631;2478539;0.013193;quickSort
156000;20020956160;90464;2661267;2751731;2480339;0.012443;quickSort
156100;20052166160;90564;2663267;2753831;2482139;0.013297;quickSort
156200;20083396160;90664;2665267;2755931;2483939;0.013366;quickSort
156300;20114646160;90764;2667267;2758031;2485739;0.012137;quickSort
156400;20145916160;90864;2669267;2760131;2487539;0.012021;quickSort
156500;20177206160;90964;2671267;2762231;2489339;0.011956;quickSort
156600;20208516160;91064;2673267;2764331;2491139;0.012945;quickSort
156700;20239846160;91164;2675267;2766431;2492939;0.011717;quickSort
156800;20271196160;91264;2677267;2768531;2494739;0.012348;quickSort
156900;20302566160;91364;2679267;2770631;2496539;0.012105;quickSort
157000;20333956160;91464;2681267;2772731;2498339;0.012016;quickSort
157100;20365366160;91564;2683267;2774831;2500139;0.012054;quickSort
157200;20396796160;91664;2685267;2776931;2501939;0.012119;quickSort
157300;20428246160;91764;2687267;2779031;2503739;0.012222;quickSort
157400;20459716160;91864;2689267;2781131;2505539;0.012189;quickSort
157500;20491206160;91964;2691267;2783231;2507339;0.012677;quickSort
157600;20522716160;92064;2693267;2785331;2509139;0.012079;quickSort
157700;20554246160;92164;2695267;2787431;2510939;0.012480;quickSort
157800;20585796160;92264;2697267;2789531;2512739;0.012102;quickSort
157900;20617366160;92364;2699267;2791631;2514539;0.012125;quickSort
158000;20648956160;92464;2701267;2793731;2516339;0.012471;quickSort
158100;20680566160;92564;2703267;2795831;2518139;0.012425;quickSort
158200;20712196160;92664;2705267;2797931;2519939;0.012131;quickSort
158300;20743846160;92764;2707267;2800031;2521739;0.012238;quickSort
158400;20775516160;92864;2709267;2802131;2523539;0.012566;quickSort
158500;20807206160;92964;2711267;2804231;2525339;0.012192;quickSort
158600;20838916160;93064;2713267;2806331;2527139;0.012146;quickSort
158700;20870646160;93164;2715267;2808431;2528939;0.012161;quickSort
158800;20902396160;93264;2717267;2810531;2530739;0.012173;quickSort
158900;20934166160;93364;2719267;2812631;2532539;0.012190;quickSort
159000;20965956160;93464;2721267;2814731;2534339;0.012212;quickSort
159100;20997766160;93564;2723267;2816831;2536139;0.012235;quickSort
159200;201029596160;93664;2725267;2818931;2537939;0.012237;quickSort
159300;201061446160;93764;2727267;2821031;2539739;0.012246;quickSort
159400;201093316160;93864;2729267;2823131;2541539;0.012674;quickSort
159500;201125206160;93964;2731267;2825231;2543339;0.012255;quickSort
159600;201157116160;94064;2733267;2827331;2545139;0.012283;quickSort
159700;201189046160;94164;2735267;2829431;2546939;0.012275;quickSort
159800;21005243968;94264;2737267;2831531;2548739;0.012359;quickSort
159900;21037213968;94364;2739267;2833631;2550539;0.012524;quickSort
160000;21069203968;94464;2741267;2835731;2552339;0.012084;quickSort
160100;21101213968;94564;2743267;2837831;2554139;0.012451;quickSort
160200;21133243968;94664;2745267;2839931;2555939;0.012375;quickSort
160300;21165293968;94764;2747267;2842031;2557739;0.012384;quickSort
160400;21197363968;94864;2749267;2844131;2559539;0.012381;quickSort
160500;21229453968;94964;2751267;2846231;2561339;0.012418;quickSort
160600;21261563968;95064;2753267;2848331;2563139;0.012400;quickSort
160700;21293693968;95164;2755267;2850431;2564939;0.012639;quickSort
160800;21325843968;95264;2757267;2852531;2566739;0.012772;quickSort
160900;21358013968;95364;2759267;2854631;2568539;0.012162;quickSort
161000;21390203968;95464;2761267;2856731;2570339;0.012403;quickSort
161100;21422413968;95564;2763267;2858831;2572139;0.012444;quickSort
161200;21454643968;95664;2765267;2860931;2573939;0.012433;quickSort
161300;21486893968;95764;2767267;2863031;2575739;0.012692;quickSort
161400;21519163968;95864;2769267;2865131;2577539;0.012917;quickSort
161500;21551453968;95964;2771267;2867231;2579339;0.013074;quickSort
161600;21583763968;96064;2773267;2869331;2581139;0.012463;quickSort
161700;21616093968;96164;2775267;2871431;2582939;0.012576;quickSort
161800;21648443968;96264;2777267;2873531;2584739;0.012173;quickSort
161900;21680813968;96364;2779267;2875631;2586539;0.012271;quickSort
162000;21713203968;96464;2781267;2877731;2588339;0.012172;quickSort
162100;21745613968;96564;2783267;2879831;2590139;0.012195;quickSort
162200;21778043968;96664;2785267;2881931;2591939;0.012482;quickSort
162300;21810493968;96764;2787267;2884031;2593739;0.012516;quickSort
162400;21842963968;96864;2789267;2886131;2595539;0.012531;quickSort
162500;21875453968;96964;2791267;2888231;2597339;0.012948;quickSort
162600;21907963968;97064;2793267;2890331;2599139;0.013176;quickSort
162700;21940493968;97164;2795267;2892431;2600939;0.012601;quickSort
162800;21973043968;97264;2797267;2894531;2602739;0.012574;quickSort
162900;211005613968;97364;2799267;2896631;2604539;0.012572;quickSort
163000;211038203968;97464;2801267;2898731;2606339;0.012587;quickSort
163100;211070813968;97564;2803267;2900831;2608139;0.012769;quickSort
163200;211103443968;97664;2805267;2902931;2609939;0.012639;quickSort
163300;211136093968;97764;2807267;2905031;2611739;0.012619;quickSort
163400;211168763968;97864;2809267;2907131;2613539;0.012646;quickSort
163500;211201453968;97964;2811267;2909231;2615339;0.012642;quickSort
163600;22018411776;98064;2813267;2911331;2617139;0.012983;quickSort
163700;22051141776;98164;2815267;2913431;2618939;0.013116;quickSort
163800;22083891776;98264;2817267;2915531;2620739;0.012665;quickSort
163900;22116661776;98364;2819267;2917631;2622539;0.012676;quickSort
164000;22149451776;98464;2821267;2919731;2624339;0.012667;quickSort
164100;22182261776;98564;2823267;2921831;2626139;0.012726;quickSort
164200;22215091776;98664;2825267;2923931;2627939;0.012693;quickSort
164300;22247941776;98764;2827267;2926031;2629739;0.012750;quickSort
164400;22280811776;98864;2829267;2928131;2631539;0.012731;quickSort
164500;22313701776;98964;2831267;2930231;2633339;0.012766;quickSort
164600;22346611776;99064;2833267;2932331;2635139;0.012766;quickSort
164700;22379541776;99164;2835267;2934431;2636939;0.012764;quickSort
164800;22412491776;99264;2837267;2936531;2638739;0.012802;quickSort
164900;22445461776;99364;2839267;2938631;2640539;0.012786;quickSort
165000;22478451776;99464;2841267;2940731;2642339;0.012846;quickSort
165100;22511461776;99564;2843267;2942831;2644139;0.012834;quickSort
165200;22544491776;99664;2845267;2944931;2645939;0.012823;quickSort
165300;22577541776;99764;2847267;2947031;2647739;0.013211;quickSort
165400;22610611776;99864;2849267;2949131;2649539;0.014498;quickSort
165500;22643701776;99964;2851267;2951231;2651339;0.013160;quickSort
165600;22676811776;100064;2853267;2953331;2653139;0.012900;quickSort
165700;22709941776;100164;2855267;2955431;2654939;0.013073;quickSort
165800;22743091776;100264;2857267;2957531;2656739;0.013584;quickSort
165900;22776261776;100364;2859267;2959631;2658539;0.013118;quickSort
166000;22809451776;100464;2861267;2961731;2660339;0.012651;quickSort
166100;22842661776;100564;2863267;2963831;2662139;0.012629;quickSort
166200;22875891776;100664;2865267;2965931;2663939;0.012607;quickSort
166300;22909141776;100764;2867267;2968031;2665739;0.012786;quickSort
166400;22942411776;100864;2869267;2970131;2667539;0.012672;quickSort
166500;22975701776;100964;2871267;2972231;2669339;0.012894;quickSort
166600;221009011776;101064;2873267;2974331;2671139;0.013084;quickSort
166700;221042341776;101164;2875267;2976431;2672939;0.013026;quickSort
166800;221075691776;101264;2877267;2978531;2674739;0.013037;quickSort
166900;221109061776;101364;2879267;2980631;2676539;0.013131;quickSort
167000;221142451776;101464;2881267;2982731;2678339;0.013060;quickSort
167100;221175861776;101564;2883267;2984831;2680139;0.013069;quickSort
167200;221209291776;101664;2885267;2986931;2681939;0.013657;quickSort
167300;23026989584;101764;2887267;2989031;2683739;0.013109;quickSort
167400;23060459584;101864;2889267;2991131;2685539;0.014288;quickSort
167500;23093949584;101964;2891267;2993231;2687339;0.013089;quickSort
167600;23127459584;102064;2893267;2995331;2689139;0.014520;quickSort
167700;23160989584;102164;2895267;2997431;2690939;0.014645;quickSort
167800;23194539584;102264;2897267;2999531;2692739;0.014540;quickSort
167900;23228109584;102364;2899267;3001631;2694539;0.013122;quickSort
168000;23261699584;102464;2901267;3003731;2696339;0.013151;quickSort
168100;23295309584;102564;2903267;3005831;2698139;0.013202;quickSort
168200;23328939584;102664;2905267;3007931;2699939;0.013233;quickSort
168300;23362589584;102764;2907267;3010031;2701739;0.013194;quickSort
168400;23396259584;102864;2909267;3012131;2703539;0.013229;quickSort
168500;23429949584;102964;2911267;3014231;2705339;0.013229;quickSort
168600;23463659584;103064;2913267;3016331;2707139;0.013217;quickSort
168700;23497389584;103164;2915267;3018431;2708939;0.013587;quickSort
168800;23531139584;103264;2917267;3020531;2710739;0.013945;quickSort
168900;23564909584;103364;2919267;3022631;2712539;0.014030;quickSort
169000;23598699584;103464;2921267;3024731;2714339;0.013063;quickSort
169100;23632509584;103564;2923267;3026831;2716139;0.013317;quickSort
169200;23666339584;103664;2925267;3028931;2717939;0.013398;quickSort
169300;23700189584;103764;2927267;3031031;2719739;0.013293;quickSort
169400;23734059584;103864;2929267;3033131;2721539;0.013316;quickSort
169500;23767949584;103964;2931267;3035231;2723339;0.013378;quickSort
169600;23801859584;104064;2933267;3037331;2725139;0.013338;quickSort
169700;23835789584;104164;2935267;3039431;2726939;0.013359;quickSort
169800;23869739584;104264;2937267;3041531;2728739;0.013375;quickSort
169900;23903709584;104364;2939267;3043631;2730539;0.013330;quickSort
170000;23937699584;104464;2941267;3045731;2732339;0.013325;quickSort
170100;23971709584;104564;2943267;3047831;2734139;0.013364;quickSort
170200;231005739584;104664;2945267;3049931;2735939;0.013488;quickSort
170300;231039789584;104764;2947267;3052031;2737739;0.013453;quickSort
170400;231073859584;104864;2949267;3054131;2739539;0.013403;quickSort
170500;231107949584;104964;2951267;3056231;2741339;0.013407;quickSort
170600;231142059584;105064;2953267;3058331;2743139;0.013427;quickSort
170700;231176189584;105164;2955267;3060431;2744939;0.013420;quickSort
170800;231210339584;105264;2957267;3062531;2746739;0.013463;quickSort
170900;24028757392;105364;2959267;3064631;2748539;0.013543;quickSort
171000;24062947392;105464;2961267;3066731;2750339;0.013522;quickSort
171100;24097157392;105564;2963267;3068831;2752139;0.014655;quickSort
171200;24131387392;105664;2965267;3070931;2753939;0.013593;quickSort
171300;24165637392;105764;2967267;3073031;2755739;0.014772;quickSort
171400;24199907392;105864;2969267;3075131;2757539;0.013336;quickSort
171500;24234197392;105964;2971267;3077231;2759339;0.013171;quickSort
171600;24268507392;106064;2973267;3079331;2761139;0.015529;quickSort
171700;24302837392;106164;2975267;3081431;2762939;0.013511;quickSort
171800;24337187392;106264;2977267;3083531;2764739;0.013582;quickSort
171900;24371557392;106364;2979267;3085631;2766539;0.013581;quickSort
172000;24405947392;106464;2981267;3087731;2768339;0.014364;quickSort
172100;24440357392;106564;2983267;3089831;2770139;0.013681;quickSort
172200;24474787392;106664;2985267;3091931;2771939;0.013774;quickSort
172300;24509237392;106764;2987267;3094031;2773739;0.013607;quickSort
172400;24543707392;106864;2989267;3096131;2775539;0.013672;quickSort
172500;24578197392;106964;2991267;3098231;2777339;0.013706;quickSort
172600;24612707392;107064;2993267;3100331;2779139;0.013623;quickSort
172700;24647237392;107164;2995267;3102431;2780939;0.013596;quickSort
172800;24681787392;107264;2997267;3104531;2782739;0.015285;quickSort
172900;24716357392;107364;2999267;3106631;2784539;0.013645;quickSort
173000;24750947392;107464;3001267;3108731;2786339;0.013687;quickSort
173100;24785557392;107564;3003267;3110831;2788139;0.013769;quickSort
173200;24820187392;107664;3005267;3112931;2789939;0.013746;quickSort
173300;24854837392;107764;3007267;3115031;2791739;0.013717;quickSort
173400;24889507392;107864;3009267;3117131;2793539;0.013747;quickSort
173500;24924197392;107964;3011267;3119231;2795339;0.014308;quickSort
173600;24958907392;108064;3013267;3121331;2797139;0.013707;quickSort
173700;24993637392;108164;3015267;3123431;2798939;0.013730;quickSort
173800;241028387392;108264;3017267;3125531;2800739;0.013696;quickSort
173900;241063157392;108364;3019267;3127631;2802539;0.013783;quickSort
174000;241097947392;108464;3021267;3129731;2804339;0.013741;quickSort
174100;241132757392;108564;3023267;3131831;2806139;0.013754;quickSort
174200;241167587392;108664;3025267;3133931;2807939;0.013790;quickSort
174300;241202437392;108764;3027267;3136031;2809739;0.013782;quickSort
174400;25021555200;108864;3029267;3138131;2811539;0.013783;quickSort
174500;25056445200;108964;3031267;3140231;2813339;0.013892;quickSort
174600;25091355200;109064;3033267;3142331;2815139;0.013885;quickSort
174700;25126285200;109164;3035267;3144431;2816939;0.013821;quickSort
174800;25161235200;109264;3037267;3146531;2818739;0.014480;quickSort
174900;25196205200;109364;3039267;3148631;2820539;0.013887;quickSort
175000;25231195200;109464;3041267;3150731;2822339;0.013910;quickSort
175100;25266205200;109564;3043267;3152831;2824139;0.013862;quickSort
175200;25301235200;109664;3045267;3154931;2825939;0.013865;quickSort
175300;25336285200;109764;3047267;3157031;2827739;0.013937;quickSort
175400;25371355200;109864;3049267;3159131;2829539;0.013924;quickSort
175500;25406445200;109964;3051267;3161231;2831339;0.013905;quickSort
175600;25441555200;110064;3053267;3163331;2833139;0.013933;quickSort
175700;25476685200;110164;3055267;3165431;2834939;0.013922;quickSort
175800;25511835200;110264;3057267;3167531;2836739;0.013937;quickSort
175900;25547005200;110364;3059267;3169631;2838539;0.014731;quickSort
176000;25582195200;110464;3061267;3171731;2840339;0.014039;quickSort
176100;25617405200;110564;3063267;3173831;2842139;0.014156;quickSort
176200;25652635200;110664;3065267;3175931;2843939;0.013708;quickSort
176300;25687885200;110764;3067267;3178031;2845739;0.013695;quickSort
176400;25723155200;110864;3069267;3180131;2847539;0.013780;quickSort
176500;25758445200;110964;3071267;3182231;2849339;0.013985;quickSort
176600;25793755200;111064;3073267;3184331;2851139;0.014027;quickSort
176700;25829085200;111164;3075267;3186431;2852939;0.014071;quickSort
176800;25864435200;111264;3077267;3188531;2854739;0.014070;quickSort
176900;25899805200;111364;3079267;3190631;2856539;0.014024;quickSort
177000;25935195200;111464;3081267;3192731;2858339;0.014040;quickSort
177100;25970605200;111564;3083267;3194831;2860139;0.014074;quickSort
177200;251006035200;111664;3085267;3196931;2861939;0.014065;quickSort
177300;251041485200;111764;3087267;3199031;2863739;0.014077;quickSort
177400;251076955200;111864;3089267;3201131;2865539;0.014143;quickSort
177500;251112445200;111964;3091267;3203231;2867339;0.014128;quickSort
177600;251147955200;112064;3093267;3205331;2869139;0.014122;quickSort
177700;251183485200;112164;3095267;3207431;2870939;0.014129;quickSort
177800;26003283008;112264;3097267;3209531;2872739;0.014129;quickSort
177900;26038853008;112364;3099267;3211631;2874539;0.014120;quickSort
178000;26074443008;112464;3101267;3213731;2876339;0.014166;quickSort
178100;26110053008;112564;3103267;3215831;2878139;0.014167;quickSort
178200;26145683008;112664;3105267;3217931;2879939;0.014196;quickSort
178300;26181333008;112764;3107267;3220031;2881739;0.014170;quickSort
178400;26217003008;112864;3109267;3222131;2883539;0.014182;quickSort
178500;26252693008;112964;3111267;3224231;2885339;0.014453;quickSort
178600;26288403008;113064;3113267;3226331;2887139;0.014419;quickSort
178700;26324133008;113164;3115267;3228431;2888939;0.015214;quickSort
178800;26359883008;113264;3117267;3230531;2890739;0.014336;quickSort
178900;26395653008;113364;3119267;3232631;2892539;0.014280;quickSort
179000;26431443008;113464;3121267;3234731;2894339;0.014218;quickSort
179100;26467253008;113564;3123267;3236831;2896139;0.014326;quickSort
179200;26503083008;113664;3125267;3238931;2897939;0.014191;quickSort
179300;26538933008;113764;3127267;3241031;2899739;0.014324;quickSort
179400;26574803008;113864;3129267;3243131;2901539;0.014229;quickSort
179500;26610693008;113964;3131267;3245231;2903339;0.014231;quickSort
179600;26646603008;114064;3133267;3247331;2905139;0.014234;quickSort
179700;26682533008;114164;3135267;3249431;2906939;0.014298;quickSort
179800;26718483008;114264;3137267;3251531;2908739;0.014963;quickSort
179900;26754453008;114364;3139267;3253631;2910539;0.014256;quickSort
180000;26790443008;114464;3141267;3255731;2912339;0.014329;quickSort
180100;26826453008;114564;3143267;3257831;2914139;0.014544;quickSort
180200;26862483008;114664;3145267;3259931;2915939;0.014592;quickSort
180300;26898533008;114764;3147267;3262031;2917739;0.014326;quickSort
180400;26934603008;114864;3149267;3264131;2919539;0.014297;quickSort
180500;26970693008;114964;3151267;3266231;2921339;0.014685;quickSort
180600;261006803008;115064;3153267;3268331;2923139;0.014469;quickSort
180700;261042933008;115164;3155267;3270431;2924939;0.014388;quickSort
180800;261079083008;115264;3157267;3272531;2926739;0.014333;quickSort
180900;261115253008;115364;3159267;3274631;2928539;0.014336;quickSort
181000;261151443008;115464;3161267;3276731;2930339;0.014367;quickSort
181100;261187653008;115564;3163267;3278831;2932139;0.014382;quickSort
181200;27008130816;115664;3165267;3280931;2933939;0.014389;quickSort
181300;27044380816;115764;3167267;3283031;2935739;0.014587;quickSort
181400;27080650816;115864;3169267;3285131;2937539;0.014420;quickSort
181500;27116940816;115964;3171267;3287231;2939339;0.014492;quickSort
181600;27153250816;116064;3173267;3289331;2941139;0.014431;quickSort
181700;27189580816;116164;3175267;3291431;2942939;0.014443;quickSort
181800;27225930816;116264;3177267;3293531;2944739;0.014425;quickSort
181900;27262300816;116364;3179267;3295631;2946539;0.014494;quickSort
182000;27298690816;116464;3181267;3297731;2948339;0.014495;quickSort
182100;27335100816;116564;3183267;3299831;2950139;0.014485;quickSort
182200;27371530816;116664;3185267;3301931;2951939;0.014501;quickSort
182300;27407980816;116764;3187267;3304031;2953739;0.014573;quickSort
182400;27444450816;116864;3189267;3306131;2955539;0.014518;quickSort
182500;27480940816;116964;3191267;3308231;2957339;0.014595;quickSort
182600;27517450816;117064;3193267;3310331;2959139;0.014909;quickSort
182700;27553980816;117164;3195267;3312431;2960939;0.016390;quickSort
182800;27590530816;117264;3197267;3314531;2962739;0.014568;quickSort
182900;27627100816;117364;3199267;3316631;2964539;0.014642;quickSort
183000;27663690816;117464;3201267;3318731;2966339;0.014707;quickSort
183100;27700300816;117564;3203267;3320831;2968139;0.014644;quickSort
183200;27736930816;117664;3205267;3322931;2969939;0.014598;quickSort
183300;27773580816;117764;3207267;3325031;2971739;0.014596;quickSort
183400;27810250816;117864;3209267;3327131;2973539;0.014624;quickSort
183500;27846940816;117964;3211267;3329231;2975339;0.014624;quickSort
183600;27883650816;118064;3213267;3331331;2977139;0.014300;quickSort
183700;27920380816;118164;3215267;3333431;2978939;0.014690;quickSort
183800;27957130816;118264;3217267;3335531;2980739;0.014677;quickSort
183900;27993900816;118364;3219267;3337631;2982539;0.014634;quickSort
184000;271030690816;118464;3221267;3339731;2984339;0.014632;quickSort
184100;271067500816;118564;3223267;3341831;2986139;0.014996;quickSort
184200;271104330816;118664;3225267;3343931;2987939;0.014691;quickSort
184300;271141180816;118764;3227267;3346031;2989739;0.014706;quickSort
184400;271178050816;118864;3229267;3348131;2991539;0.014715;quickSort
184500;271214940816;118964;3231267;3350231;2993339;0.014788;quickSort
184600;28036098624;119064;3233267;3352331;2995139;0.014722;quickSort
184700;28073028624;119164;3235267;3354431;2996939;0.014753;quickSort
184800;28109978624;119264;3237267;3356531;2998739;0.014731;quickSort
184900;28146948624;119364;3239267;3358631;3000539;0.014841;quickSort
185000;28183938624;119464;3241267;3360731;3002339;0.015213;quickSort
185100;28220948624;119564;3243267;3362831;3004139;0.014777;quickSort
185200;28257978624;119664;3245267;3364931;3005939;0.015094;quickSort
185300;28295028624;119764;3247267;3367031;3007739;0.014792;quickSort
185400;28332098624;119864;3249267;3369131;3009539;0.014801;quickSort
185500;28369188624;119964;3251267;3371231;3011339;0.014865;quickSort
185600;28406298624;120064;3253267;3373331;3013139;0.014813;quickSort
185700;28443428624;120164;3255267;3375431;3014939;0.014923;quickSort
185800;28480578624;120264;3257267;3377531;3016739;0.014829;quickSort
185900;28517748624;120364;3259267;3379631;3018539;0.014858;quickSort
186000;28554938624;120464;3261267;3381731;3020339;0.014866;quickSort
186100;28592148624;120564;3263267;3383831;3022139;0.015007;quickSort
186200;28629378624;120664;3265267;3385931;3023939;0.014516;quickSort
186300;28666628624;120764;3267267;3388031;3025739;0.014505;quickSort
186400;28703898624;120864;3269267;3390131;3027539;0.014590;quickSort
186500;28741188624;120964;3271267;3392231;3029339;0.014886;quickSort
186600;28778498624;121064;3273267;3394331;3031139;0.015378;quickSort
186700;28815828624;121164;3275267;3396431;3032939;0.014958;quickSort
186800;28853178624;121264;3277267;3398531;3034739;0.014916;quickSort
186900;28890548624;121364;3279267;3400631;3036539;0.014957;quickSort
187000;28927938624;121464;3281267;3402731;3038339;0.014946;quickSort
187100;28965348624;121564;3283267;3404831;3040139;0.015976;quickSort
187200;281002778624;121664;3285267;3406931;3041939;0.015058;quickSort
187300;281040228624;121764;3287267;3409031;3043739;0.015007;quickSort
187400;281077698624;121864;3289267;3411131;3045539;0.014946;quickSort
187500;281115188624;121964;3291267;3413231;3047339;0.014998;quickSort
187600;281152698624;122064;3293267;3415331;3049139;0.014986;quickSort
187700;281190228624;122164;3295267;3417431;3050939;0.015029;quickSort
187800;29012026432;122264;3297267;3419531;3052739;0.015009;quickSort
187900;29049596432;122364;3299267;3421631;3054539;0.015027;quickSort
188000;29087186432;122464;3301267;3423731;3056339;0.015975;quickSort
188100;29124796432;122564;3303267;3425831;3058139;0.015047;quickSort
188200;29162426432;122664;3305267;3427931;3059939;0.015069;quickSort
188300;29200076432;122764;3307267;3430031;3061739;0.015058;quickSort
188400;29237746432;122864;3309267;3432131;3063539;0.015061;quickSort
188500;29275436432;122964;3311267;3434231;3065339;0.015090;quickSort
188600;29313146432;123064;3313267;3436331;3067139;0.015092;quickSort
188700;29350876432;123164;3315267;3438431;3068939;0.015087;quickSort
188800;29388626432;123264;3317267;3440531;3070739;0.015149;quickSort
188900;29426396432;123364;3319267;3442631;3072539;0.015118;quickSort
189000;29464186432;123464;3321267;3444731;3074339;0.015401;quickSort
189100;29501996432;123564;3323267;3446831;3076139;0.015466;quickSort
189200;29539826432;123664;3325267;3448931;3077939;0.015443;quickSort
189300;29577676432;123764;3327267;3451031;3079739;0.015149;quickSort
189400;29615546432;123864;3329267;3453131;3081539;0.015189;quickSort
189500;29653436432;123964;3331267;3455231;3083339;0.015173;quickSort
189600;29691346432;124064;3333267;3457331;3085139;0.015201;quickSort
189700;29729276432;124164;3335267;3459431;3086939;0.015193;quickSort
189800;29767226432;124264;3337267;3461531;3088739;0.015212;quickSort
189900;29805196432;124364;3339267;3463631;3090539;0.015198;quickSort
190000;29843186432;124464;3341267;3465731;3092339;0.015225;quickSort
190100;29881196432;124564;3343267;3467831;3094139;0.015213;quickSort
190200;29919226432;124664;3345267;3469931;3095939;0.015262;quickSort
190300;29957276432;124764;3347267;3472031;3097739;0.015273;quickSort
190400;29995346432;124864;3349267;3474131;3099539;0.015314;quickSort
190500;291033436432;124964;3351267;3476231;3101339;0.015281;quickSort
190600;291071546432;125064;3353267;3478331;3103139;0.015274;quickSort
190700;291109676432;125164;3355267;3480431;3104939;0.014899;quickSort
190800;291147826432;125264;3357267;3482531;3106739;0.014926;quickSort
190900;291185996432;125364;3359267;3484631;3108539;0.014910;quickSort
191000;30008434240;125464;3361267;3486731;3110339;0.015363;quickSort
191100;30046644240;125564;3363267;3488831;3112139;0.015379;quickSort
191200;30084874240;125664;3365267;3490931;3113939;0.015331;quickSort
191300;30123124240;125764;3367267;3493031;3115739;0.015368;quickSort
191400;30161394240;125864;3369267;3495131;3117539;0.015363;quickSort
191500;30199684240;125964;3371267;3497231;3119339;0.015954;quickSort
191600;30237994240;126064;3373267;3499331;3121139;0.015460;quickSort
191700;30276324240;126164;3375267;3501431;3122939;0.015879;quickSort
191800;30314674240;126264;3377267;3503531;3124739;0.015417;quickSort
191900;30353044240;126364;3379267;3505631;3126539;0.015449;quickSort
192000;30391434240;126464;3381267;3507731;3128339;0.015378;quickSort
192100;30429844240;126564;3383267;3509831;3130139;0.016622;quickSort
192200;30468274240;126664;3385267;3511931;3131939;0.015914;quickSort
192300;30506724240;126764;3387267;3514031;3133739;0.015457;quickSort
192400;30545194240;126864;3389267;3516131;3135539;0.015501;quickSort
192500;30583684240;126964;3391267;3518231;3137339;0.017000;quickSort
192600;30622194240;127064;3393267;3520331;3139139;0.015475;quickSort
192700;30660724240;127164;3395267;3522431;3140939;0.015453;quickSort
192800;30699274240;127264;3397267;3524531;3142739;0.015512;quickSort
192900;30737844240;127364;3399267;3526631;3144539;0.015502;quickSort
193000;30776434240;127464;3401267;3528731;3146339;0.015527;quickSort
193100;30815044240;127564;3403267;3530831;3148139;0.016097;quickSort
193200;30853674240;127664;3405267;3532931;3149939;0.015565;quickSort
193300;30892324240;127764;3407267;3535031;3151739;0.015678;quickSort
193400;30930994240;127864;3409267;3537131;3153539;0.015558;quickSort
193500;30969684240;127964;3411267;3539231;3155339;0.016041;quickSort
193600;301008394240;128064;3413267;3541331;3157139;0.015595;quickSort
193700;301047124240;128164;3415267;3543431;3158939;0.015582;quickSort
193800;301085874240;128264;3417267;3545531;3160739;0.015560;quickSort
193900;301124644240;128364;3419267;3547631;3162539;0.015982;quickSort
194000;301163434240;128464;3421267;3549731;3164339;0.016974;quickSort
194100;301202244240;128564;3423267;3551831;3166139;0.015633;quickSort
194200;31025322048;128664;3425267;3553931;3167939;0.015656;quickSort
194300;31064172048;128764;3427267;3556031;3169739;0.015670;quickSort
194400;31103042048;128864;3429267;3558131;3171539;0.015643;quickSort
194500;31141932048;128964;3431267;3560231;3173339;0.015720;quickSort
194600;31180842048;129064;3433267;3562331;3175139;0.015668;quickSort
194700;31219772048;129164;3435267;3564431;3176939;0.015637;quickSort
194800;31258722048;129264;3437267;3566531;3178739;0.016525;quickSort
194900;31297692048;129364;3439267;3568631;3180539;0.016253;quickSort
195000;31336682048;129464;3441267;3570731;3182339;0.015701;quickSort
195100;31375692048;129564;3443267;3572831;3184139;0.015688;quickSort
195200;31414722048;129664;3445267;3574931;3185939;0.015707;quickSort
195300;31453772048;129764;3447267;3577031;3187739;0.016151;quickSort
195400;31492842048;129864;3449267;3579131;3189539;0.015979;quickSort
195500;31531932048;129964;3451267;3581231;3191339;0.015755;quickSort
195600;31571042048;130064;3453267;3583331;3193139;0.015758;quickSort
195700;31610172048;130164;3455267;3585431;3194939;0.016460;quickSort
195800;31649322048;130264;3457267;3587531;3196739;0.015778;quickSort
195900;31688492048;130364;3459267;3589631;3198539;0.015856;quickSort
196000;31727682048;130464;3461267;3591731;3200339;0.015811;quickSort
196100;31766892048;130564;3463267;3593831;3202139;0.015833;quickSort
196200;31806122048;130664;3465267;3595931;3203939;0.016064;quickSort
196300;31845372048;130764;3467267;3598031;3205739;0.016235;quickSort
196400;31884642048;130864;3469267;3600131;3207539;0.015811;quickSort
196500;31923932048;130964;3471267;3602231;3209339;0.015822;quickSort
196600;31963242048;131064;3473267;3604331;3211139;0.015836;quickSort
196700;311002572048;131071;3474988;3606059;3212846;0.015848;quickSort
196800;311041922048;131071;3476688;3607759;3214546;0.015880;quickSort
196900;311081292048;131071;3478388;3609459;3216246;0.015952;quickSort
197000;311120682048;131071;3480088;3611159;3217946;0.015907;quickSort
197100;311160092048;131071;3481788;3612859;3219646;0.015980;quickSort
197200;311199522048;131071;3483488;3614559;3221346;0.015917;quickSort
197300;32023219856;131071;3485188;3616259;3223046;0.015904;quickSort
197400;32062689856;131071;3486888;3617959;3224746;0.016353;quickSort
197500;32102179856;131071;3488588;3619659;3226446;0.015982;quickSort
197600;32141689856;131071;3490288;3621359;3228146;0.015538;quickSort
197700;32181219856;131071;3491988;3623059;3229846;0.015944;quickSort
197800;32220769856;131071;3493688;3624759;3231546;0.015940;quickSort
197900;32260339856;131071;3495388;3626459;3233246;0.015981;quickSort
198000;32299929856;131071;3497088;3628159;3234946;0.015985;quickSort
198100;32339539856;131071;3498788;3629859;3236646;0.015969;quickSort
198200;32379169856;131071;3500488;3631559;3238346;0.015966;quickSort
198300;32418819856;131071;3502188;3633259;3240046;0.016019;quickSort
198400;32458489856;131071;3503888;3634959;3241746;0.016057;quickSort
198500;32498179856;131071;3505588;3636659;3243446;0.016101;quickSort
198600;32537889856;131071;3507288;3638359;3245146;0.015971;quickSort
198700;32577619856;131071;3508988;3640059;3246846;0.016042;quickSort
198800;32617369856;131071;3510688;3641759;3248546;0.015901;quickSort
198900;32657139856;131071;3512388;3643459;3250246;0.015630;quickSort
199000;32696929856;131071;3514088;3645159;3251946;0.015650;quickSort
199100;32736739856;131071;3515788;3646859;3253646;0.015659;quickSort
199200;32776569856;131071;3517488;3648559;3255346;0.016060;quickSort
199300;32816419856;131071;3519188;3650259;3257046;0.016171;quickSort
199400;32856289856;131071;3520888;3651959;3258746;0.016145;quickSort
199500;32896179856;131071;3522588;3653659;3260446;0.016160;quickSort
199600;32936089856;131071;3524288;3655359;3262146;0.016148;quickSort
199700;32976019856;131071;3525988;3657059;3263846;0.016152;quickSort
199800;321015969856;131071;3527688;3658759;3265546;0.016133;quickSort
199900;321055939856;131071;3529388;3660459;3267246;0.016180;quickSort
200000;321095929856;131071;3531088;3662159;3268946;0.016173;quickSort
200100;321135939856;131071;3532788;3663859;3270646;0.016201;quickSort
200200;321175969856;131071;3534488;3665559;3272346;0.016175;quickSort
200300;33000267664;131071;3536188;3667259;3274046;0.016183;quickSort
200400;33040337664;131071;3537888;3668959;3275746;0.016324;quickSort
200500;33080427664;131071;3539588;3670659;3277446;0.016226;quickSort
200600;33120537664;131071;3541288;3672359;3279146;0.016246;quickSort
200700;33160667664;131071;3542988;3674059;3280846;0.016219;quickSort
200800;33200817664;131071;3544688;3675759;3282546;0.016503;quickSort
200900;33240987664;131071;3546388;3677459;3284246;0.016753;quickSort
201000;33281177664;131071;3548088;3679159;3285946;0.016243;quickSort
201100;33321387664;131071;3549788;3680859;3287646;0.016215;quickSort
201200;33361617664;131071;3551488;3682559;3289346;0.016263;quickSort
201300;33401867664;131071;3553188;3684259;3291046;0.016271;quickSort
201400;33442137664;131071;3554888;3685959;3292746;0.016267;quickSort
201500;33482427664;131071;3556588;3687659;3294446;0.016280;quickSort
201600;33522737664;131071;3558288;3689359;3296146;0.016889;quickSort
201700;33563067664;131071;3559988;3691059;3297846;0.016518;quickSort
201800;33603417664;131071;3561688;3692759;3299546;0.016393;quickSort
201900;33643787664;131071;3563388;3694459;3301246;0.016311;quickSort
202000;33684177664;131071;3565088;3696159;3302946;0.016389;quickSort
202100;33724587664;131071;3566788;3697859;3304646;0.016313;quickSort
202200;33765017664;131071;3568488;3699559;3306346;0.016343;quickSort
202300;33805467664;131071;3570188;3701259;3308046;0.016369;quickSort
202400;33845937664;131071;3571888;3702959;3309746;0.016315;quickSort
202500;33886427664;131071;3573588;3704659;3311446;0.016400;quickSort
202600;33926937664;131071;3575288;3706359;3313146;0.016362;quickSort
202700;33967467664;131071;3576988;3708059;3314846;0.016390;quickSort
202800;331008017664;131071;3578688;3709759;3316546;0.016346;quickSort
202900;331048587664;131071;3580388;3711459;3318246;0.016824;quickSort
203000;331089177664;131071;3582088;3713159;3319946;0.016374;quickSort
203100;331129787664;131071;3583788;3714859;3321646;0.017069;quickSort
203200;331170417664;131071;3585488;3716559;3323346;0.017358;quickSort
203300;331211067664;131071;3587188;3718259;3325046;0.016726;quickSort
203400;34035985472;131071;3588888;3719959;3326746;0.016483;quickSort
203500;34076675472;131071;3590588;3721659;3328446;0.016531;quickSort
203600;34117385472;131071;3592288;3723359;3330146;0.016559;quickSort
203700;34158115472;131071;3593988;3725059;3331846;0.016510;quickSort
203800;34198865472;131071;3595688;3726759;3333546;0.016572;quickSort
203900;34239635472;131071;3597388;3728459;3335246;0.016458;quickSort
204000;34280425472;131071;3599088;3730159;3336946;0.016490;quickSort
204100;34321235472;131071;3600788;3731859;3338646;0.016515;quickSort
204200;34362065472;131071;3602488;3733559;3340346;0.016498;quickSort
204300;34402915472;131071;3604188;3735259;3342046;0.016505;quickSort
204400;34443785472;131071;3605888;3736959;3343746;0.016616;quickSort
204500;34484675472;131071;3607588;3738659;3345446;0.016646;quickSort
204600;34525585472;131071;3609288;3740359;3347146;0.016550;quickSort
204700;34566515472;131071;3610988;3742059;3348846;0.016893;quickSort
204800;34607465472;131071;3612688;3743759;3350546;0.016584;quickSort
204900;34648435472;131071;3614388;3745459;3352246;0.016660;quickSort
205000;34689425472;131071;3616088;3747159;3353946;0.016650;quickSort
205100;34730435472;131071;3617788;3748859;3355646;0.016565;quickSort
205200;34771465472;131071;3619488;3750559;3357346;0.016597;quickSort
205300;34812515472;131071;3621188;3752259;3359046;0.016625;quickSort
205400;34853585472;131071;3622888;3753959;3360746;0.017147;quickSort
205500;34894675472;131071;3624588;3755659;3362446;0.016608;quickSort
205600;34935785472;131071;3626288;3757359;3364146;0.016590;quickSort
205700;34976915472;131071;3627988;3759059;3365846;0.016626;quickSort
205800;341018065472;131071;3629688;3760759;3367546;0.017047;quickSort
205900;341059235472;131071;3631388;3762459;3369246;0.016628;quickSort
206000;341100425472;131071;3633088;3764159;3370946;0.016665;quickSort
206100;341141635472;131071;3634788;3765859;3372646;0.016620;quickSort
206200;341182865472;131071;3636488;3767559;3374346;0.016619;quickSort
206300;35008363280;131071;3638188;3769259;3376046;0.016625;quickSort
206400;35049633280;131071;3639888;3770959;3377746;0.016661;quickSort
206500;35090923280;131071;3641588;3772659;3379446;0.016654;quickSort
206600;35132233280;131071;3643288;3774359;3381146;0.016680;quickSort
206700;35173563280;131071;3644988;3776059;3382846;0.016706;quickSort
206800;35214913280;131071;3646688;3777759;3384546;0.016698;quickSort
206900;35256283280;131071;3648388;3779459;3386246;0.016684;quickSort
207000;35297673280;131071;3650088;3781159;3387946;0.017406;quickSort
207100;35339083280;131071;3651788;3782859;3389646;0.016315;quickSort
207200;35380513280;131071;3653488;3784559;3391346;0.016766;quickSort
207300;35421963280;131071;3655188;3786259;3393046;0.016712;quickSort
207400;35463433280;131071;3656888;3787959;3394746;0.016712;quickSort
207500;35504923280;131071;3658588;3789659;3396446;0.016741;quickSort
207600;35546433280;131071;3660288;3791359;3398146;0.016604;quickSort
207700;35587963280;131071;3661988;3793059;3399846;0.016884;quickSort
207800;35629513280;131071;3663688;3794759;3401546;0.016913;quickSort
207900;35671083280;131071;3665388;3796459;3403246;0.016802;quickSort
208000;35712673280;131071;3667088;3798159;3404946;0.017168;quickSort
208100;35754283280;131071;3668788;3799859;3406646;0.016839;quickSort
208200;35795913280;131071;3670488;3801559;3408346;0.017377;quickSort
208300;35837563280;131071;3672188;3803259;3410046;0.016816;quickSort
208400;35879233280;131071;3673888;3804959;3411746;0.016823;quickSort
208500;35920923280;131071;3675588;3806659;3413446;0.016819;quickSort
208600;35962633280;131071;3677288;3808359;3415146;0.016852;quickSort
208700;351004363280;131071;3678988;3810059;3416846;0.016857;quickSort
208800;351046113280;131071;3680688;3811759;3418546;0.016902;quickSort
208900;351087883280;131071;3682388;3813459;3420246;0.016839;quickSort
209000;351129673280;131071;3684088;3815159;3421946;0.016834;quickSort
209100;351171483280;131071;3685788;3816859;3423646;0.016870;quickSort
209200;351213313280;131071;3687488;3818559;3425346;0.016600;quickSort
209300;36039411088;131071;3689188;3820259;3427046;0.017017;quickSort
209400;36081281088;131071;3690888;3821959;3428746;0.016902;quickSort
209500;36123171088;131071;3692588;3823659;3430446;0.017305;quickSort
209600;36165081088;131071;3694288;3825359;3432146;0.017030;quickSort
209700;36207011088;131071;3695988;3827059;3433846;0.017012;quickSort
209800;36248961088;131071;3697688;3828759;3435546;0.016936;quickSort
209900;36290931088;131071;3699388;3830459;3437246;0.017045;quickSort
210000;36332921088;131071;3701088;3832159;3438946;0.016885;quickSort
210100;36374931088;131071;3702788;3833859;3440646;0.016910;quickSort
210200;36416961088;131071;3704488;3835559;3442346;0.016892;quickSort
210300;36459011088;131071;3706188;3837259;3444046;0.016946;quickSort
210400;36501081088;131071;3707888;3838959;3445746;0.016926;quickSort
210500;36543171088;131071;3709588;3840659;3447446;0.016951;quickSort
210600;36585281088;131071;3711288;3842359;3449146;0.016931;quickSort
210700;36627411088;131071;3712988;3844059;3450846;0.016951;quickSort
210800;36669561088;131071;3714688;3845759;3452546;0.016990;quickSort
210900;36711731088;131071;3716388;3847459;3454246;0.017052;quickSort
211000;36753921088;131071;3718088;3849159;3455946;0.016928;quickSort
211100;36796131088;131071;3719788;3850859;3457646;0.016962;quickSort
211200;36838361088;131071;3721488;3852559;3459346;0.016969;quickSort
211300;36880611088;131071;3723188;3854259;3461046;0.016926;quickSort
211400;36922881088;131071;3724888;3855959;3462746;0.016983;quickSort
211500;36965171088;131071;3726588;3857659;3464446;0.017117;quickSort
211600;361007481088;131071;3728288;3859359;3466146;0.016984;quickSort
211700;361049811088;131071;3729988;3861059;3467846;0.016989;quickSort
211800;361092161088;131071;3731688;3862759;3469546;0.016993;quickSort
211900;361134531088;131071;3733388;3864459;3471246;0.017039;quickSort
212000;361176921088;131071;3735088;3866159;3472946;0.017044;quickSort
212100;37003578896;131071;3736788;3867859;3474646;0.016998;quickSort
212200;37046008896;131071;3738488;3869559;3476346;0.017019;quickSort
212300;37088458896;131071;3740188;3871259;3478046;0.017035;quickSort
212400;37130928896;131071;3741888;3872959;3479746;0.017086;quickSort
212500;37173418896;131071;3743588;3874659;3481446;0.017086;quickSort
212600;37215928896;131071;3745288;3876359;3483146;0.016996;quickSort
212700;37258458896;131071;3746988;3878059;3484846;0.017103;quickSort
212800;37301008896;131071;3748688;3879759;3486546;0.017055;quickSort
212900;37343578896;131071;3750388;3881459;3488246;0.017821;quickSort
213000;37386168896;131071;3752088;3883159;3489946;0.017120;quickSort
213100;37428778896;131071;3753788;3884859;3491646;0.017097;quickSort
213200;37471408896;131071;3755488;3886559;3493346;0.017091;quickSort
213300;37514058896;131071;3757188;3888259;3495046;0.017209;quickSort
213400;37556728896;131071;3758888;3889959;3496746;0.017120;quickSort
213500;37599418896;131071;3760588;3891659;3498446;0.017300;quickSort
213600;37642128896;131071;3762288;3893359;3500146;0.017958;quickSort
213700;37684858896;131071;3763988;3895059;3501846;0.018288;quickSort
213900;37770378896;131071;3767388;3898459;3505246;0.018414;quickSort
214000;37813168896;131071;3769088;3900159;3506946;0.017157;quickSort
214100;37855978896;131071;3770788;3901859;3508646;0.017149;quickSort
214200;37898808896;131071;3772488;3903559;3510346;0.017090;quickSort
214300;37941658896;131071;3774188;3905259;3512046;0.017162;quickSort
214400;37984528896;131071;3775888;3906959;3513746;0.017211;quickSort
214500;371027418896;131071;3777588;3908659;3515446;0.017138;quickSort
214600;371070328896;131071;3779288;3910359;3517146;0.017194;quickSort
214700;371113258896;131071;3780988;3912059;3518846;0.017184;quickSort
214800;371156208896;131071;3782688;3913759;3520546;0.017199;quickSort
214900;371199178896;131071;3784388;3915459;3522246;0.017237;quickSort
215000;38026416704;131071;3786088;3917159;3523946;0.017167;quickSort
215100;38069426704;131071;3787788;3918859;3525646;0.017208;quickSort
215200;38112456704;131071;3789488;3920559;3527346;0.017236;quickSort
215300;38155506704;131071;3791188;3922259;3529046;0.017182;quickSort
215400;38198576704;131071;3792888;3923959;3530746;0.017211;quickSort
215500;38241666704;131071;3794588;3925659;3532446;0.017252;quickSort
215600;38284776704;131071;3796288;3927359;3534146;0.017210;quickSort
215700;38327906704;131071;3797988;3929059;3535846;0.017218;quickSort
215800;38371056704;131071;3799688;3930759;3537546;0.017198;quickSort
215900;38414226704;131071;3801388;3932459;3539246;0.017251;quickSort
216000;38457416704;131071;3803088;3934159;3540946;0.017342;quickSort
216100;38500626704;131071;3804788;3935859;3542646;0.017267;quickSort
216200;38543856704;131071;3806488;3937559;3544346;0.017317;quickSort
216300;38587106704;131071;3808188;3939259;3546046;0.017254;quickSort
216400;38630376704;131071;3809888;3940959;3547746;0.017245;quickSort
216500;38673666704;131071;3811588;3942659;3549446;0.017273;quickSort
216600;38716976704;131071;3813288;3944359;3551146;0.017324;quickSort
216700;38760306704;131071;3814988;3946059;3552846;0.017640;quickSort
216900;38847026704;131071;3818388;3949459;3556246;0.017270;quickSort
217000;38890416704;131071;3820088;3951159;3557946;0.017294;quickSort
217100;38933826704;131071;3821788;3952859;3559646;0.017490;quickSort
217200;38977256704;131071;3823488;3954559;3561346;0.017371;quickSort
217300;381020706704;131071;3825188;3956259;3563046;0.017357;quickSort
217400;381064176704;131071;3826888;3957959;3564746;0.017309;quickSort
217500;381107666704;131071;3828588;3959659;3566446;0.017313;quickSort
217600;381151176704;131071;3830288;3961359;3568146;0.017350;quickSort
217700;381194706704;131071;3831988;3963059;3569846;0.017425;quickSort
217800;39022504512;131071;3833688;3964759;3571546;0.017725;quickSort
217900;39066074512;131071;3835388;3966459;3573246;0.017367;quickSort
218000;39109664512;131071;3837088;3968159;3574946;0.017352;quickSort
218100;39153274512;131071;3838788;3969859;3576646;0.017364;quickSort
218200;39196904512;131071;3840488;3971559;3578346;0.017433;quickSort
218300;39240554512;131071;3842188;3973259;3580046;0.017387;quickSort
218400;39284224512;131071;3843888;3974959;3581746;0.017411;quickSort
218500;39327914512;131071;3845588;3976659;3583446;0.017414;quickSort
218600;39371624512;131071;3847288;3978359;3585146;0.017416;quickSort
218700;39415354512;131071;3848988;3980059;3586846;0.017446;quickSort
218800;39459104512;131071;3850688;3981759;3588546;0.017418;quickSort
218900;39502874512;131071;3852388;3983459;3590246;0.017199;quickSort
219000;39546664512;131071;3854088;3985159;3591946;0.017560;quickSort
219100;39590474512;131071;3855788;3986859;3593646;0.017036;quickSort
219200;39634304512;131071;3857488;3988559;3595346;0.017805;quickSort
219300;39678154512;131071;3859188;3990259;3597046;0.017488;quickSort
219400;39722024512;131071;3860888;3991959;3598746;0.018387;quickSort
219500;39765914512;131071;3862588;3993659;3600446;0.017806;quickSort
219600;39809824512;131071;3864288;3995359;3602146;0.017608;quickSort
219700;39853754512;131071;3865988;3997059;3603846;0.017495;quickSort
219800;39897704512;131071;3867688;3998759;3605546;0.017559;quickSort
219900;39941674512;131071;3869388;4000459;3607246;0.017582;quickSort
220000;39985664512;131071;3871088;4002159;3608946;0.017527;quickSort
220100;391029674512;131071;3872788;4003859;3610646;0.017527;quickSort
220200;391073704512;131071;3874488;4005559;3612346;0.017532;quickSort
220300;391117754512;131071;3876188;4007259;3614046;0.017529;quickSort
220400;391161824512;131071;3877888;4008959;3615746;0.017565;quickSort
220500;391205914512;131071;3879588;4010659;3617446;0.017535;quickSort
220600;40034272320;131071;3881288;4012359;3619146;0.017864;quickSort
220700;40078402320;131071;3882988;4014059;3620846;0.017543;quickSort
220800;40122552320;131071;3884688;4015759;3622546;0.017148;quickSort
220900;40166722320;131071;3886388;4017459;3624246;0.017151;quickSort
221000;40210912320;131071;3888088;4019159;3625946;0.017131;quickSort
221100;40255122320;131071;3889788;4020859;3627646;0.017565;quickSort
221200;40299352320;131071;3891488;4022559;3629346;0.017568;quickSort
221300;40343602320;131071;3893188;4024259;3631046;0.017576;quickSort
221400;40387872320;131071;3894888;4025959;3632746;0.017609;quickSort
221500;40432162320;131071;3896588;4027659;3634446;0.017632;quickSort
221600;40476472320;131071;3898288;4029359;3636146;0.017648;quickSort
221700;40520802320;131071;3899988;4031059;3637846;0.017602;quickSort
221800;40565152320;131071;3901688;4032759;3639546;0.017622;quickSort
221900;40609522320;131071;3903388;4034459;3641246;0.017636;quickSort
222000;40653912320;131071;3905088;4036159;3642946;0.017603;quickSort
222100;40698322320;131071;3906788;4037859;3644646;0.017627;quickSort
222200;40742752320;131071;3908488;4039559;3646346;0.017625;quickSort
222300;40787202320;131071;3910188;4041259;3648046;0.017642;quickSort
222400;40831672320;131071;3911888;4042959;3649746;0.017597;quickSort
222500;40876162320;131071;3913588;4044659;3651446;0.017669;quickSort
222600;40920672320;131071;3915288;4046359;3653146;0.017656;quickSort
222700;40965202320;131071;3916988;4048059;3654846;0.017702;quickSort
222800;401009752320;131071;3918688;4049759;3656546;0.017228;quickSort
222900;401054322320;131071;3920388;4051459;3658246;0.017687;quickSort
223000;401098912320;131071;3922088;4053159;3659946;0.017746;quickSort
223100;401143522320;131071;3923788;4054859;3661646;0.017651;quickSort
223200;401188152320;131071;3925488;4056559;3663346;0.017686;quickSort
223300;41017050128;131071;3927188;4058259;3665046;0.017702;quickSort
223400;41061720128;131071;3928888;4059959;3666746;0.017711;quickSort
223500;41106410128;131071;3930588;4061659;3668446;0.018656;quickSort
223600;41151120128;131071;3932288;4063359;3670146;0.017855;quickSort
223700;41195850128;131071;3933988;4065059;3671846;0.018225;quickSort
223800;41240600128;131071;3935688;4066759;3673546;0.017739;quickSort
223900;41285370128;131071;3937388;4068459;3675246;0.017651;quickSort
224000;41330160128;131071;3939088;4070159;3676946;0.017708;quickSort
224100;41374970128;131071;3940788;4071859;3678646;0.017718;quickSort
224200;41419800128;131071;3942488;4073559;3680346;0.017755;quickSort
224300;41464650128;131071;3944188;4075259;3682046;0.017675;quickSort
224400;41509520128;131071;3945888;4076959;3683746;0.017666;quickSort
224500;41554410128;131071;3947588;4078659;3685446;0.017708;quickSort
224600;41599320128;131071;3949288;4080359;3687146;0.017761;quickSort
224700;41644250128;131071;3950988;4082059;3688846;0.017311;quickSort
224800;41689200128;131071;3952688;4083759;3690546;0.017282;quickSort
224900;41734170128;131071;3954388;4085459;3692246;0.017306;quickSort
225000;41779160128;131071;3956088;4087159;3693946;0.017745;quickSort
225100;41824170128;131071;3957788;4088859;3695646;0.017769;quickSort
225200;41869200128;131071;3959488;4090559;3697346;0.018097;quickSort
225300;41914250128;131071;3961188;4092259;3699046;0.017801;quickSort
225400;41959320128;131071;3962888;4093959;3700746;0.017745;quickSort
225500;411004410128;131071;3964588;4095659;3702446;0.017756;quickSort
225600;411049520128;131071;3966288;4097359;3704146;0.017741;quickSort
225700;411094650128;131071;3967988;4099059;3705846;0.017756;quickSort
225800;411139800128;131071;3969688;4100759;3707546;0.017783;quickSort
225900;411184970128;131071;3971388;4102459;3709246;0.017773;quickSort
226000;42014407936;131071;3973088;4104159;3710946;0.017764;quickSort
226100;42059617936;131071;3974788;4105859;3712646;0.017807;quickSort
226200;42104847936;131071;3976488;4107559;3714346;0.017759;quickSort
226300;42150097936;131071;3978188;4109259;3716046;0.017807;quickSort
226400;42195367936;131071;3979888;4110959;3717746;0.017815;quickSort
226500;42240657936;131071;3981588;4112659;3719446;0.017799;quickSort
226600;42285967936;131071;3983288;4114359;3721146;0.017832;quickSort
226700;42331297936;131071;3984988;4116059;3722846;0.017805;quickSort
226800;42376647936;131071;3986688;4117759;3724546;0.017816;quickSort
226900;42422017936;131071;3988388;4119459;3726246;0.017878;quickSort
227000;42467407936;131071;3990088;4121159;3727946;0.017815;quickSort
227100;42512817936;131071;3991788;4122859;3729646;0.017801;quickSort
227200;42558247936;131071;3993488;4124559;3731346;0.017812;quickSort
227300;42603697936;131071;3995188;4126259;3733046;0.018476;quickSort
227400;42649167936;131071;3996888;4127959;3734746;0.017946;quickSort
227500;42694657936;131071;3998588;4129659;3736446;0.018060;quickSort
227600;42740167936;131071;4000288;4131359;3738146;0.017900;quickSort
227700;42785697936;131071;4001988;4133059;3739846;0.017952;quickSort
227800;42831247936;131071;4003688;4134759;3741546;0.018201;quickSort
227900;42876817936;131071;4005388;4136459;3743246;0.017866;quickSort
228000;42922407936;131071;4007088;4138159;3744946;0.017895;quickSort
228100;42968017936;131071;4008788;4139859;3746646;0.018111;quickSort
228200;421013647936;131071;4010488;4141559;3748346;0.017882;quickSort
228300;421059297936;131071;4012188;4143259;3750046;0.017929;quickSort
228400;421104967936;131071;4013888;4144959;3751746;0.017892;quickSort
228500;421150657936;131071;4015588;4146659;3753446;0.017890;quickSort
228600;421196367936;131071;4017288;4148359;3755146;0.017452;quickSort
228700;43026345744;131071;4018988;4150059;3756846;0.017441;quickSort
228800;43072095744;131071;4020688;4151759;3758546;0.018076;quickSort
228900;43117865744;131071;4022388;4153459;3760246;0.017930;quickSort
229000;43163655744;131071;4024088;4155159;3761946;0.017909;quickSort
229100;43209465744;131071;4025788;4156859;3763646;0.017910;quickSort
229200;43255295744;131071;4027488;4158559;3765346;0.017896;quickSort
229300;43301145744;131071;4029188;4160259;3767046;0.017929;quickSort
229400;43347015744;131071;4030888;4161959;3768746;0.017939;quickSort
229500;43392905744;131071;4032588;4163659;3770446;0.017907;quickSort
229600;43438815744;131071;4034288;4165359;3772146;0.017948;quickSort
229700;43484745744;131071;4035988;4167059;3773846;0.017964;quickSort
229800;43530695744;131071;4037688;4168759;3775546;0.017998;quickSort
229900;43576665744;131071;4039388;4170459;3777246;0.018470;quickSort
230000;43622655744;131071;4041088;4172159;3778946;0.017983;quickSort
230100;43668665744;131071;4042788;4173859;3780646;0.017984;quickSort
230200;43714695744;131071;4044488;4175559;3782346;0.017979;quickSort
230300;43760745744;131071;4046188;4177259;3784046;0.018035;quickSort
230400;43806815744;131071;4047888;4178959;3785746;0.018004;quickSort
230500;43852905744;131071;4049588;4180659;3787446;0.017997;quickSort
230600;43899015744;131071;4051288;4182359;3789146;0.018054;quickSort
230700;43945145744;131071;4052988;4184059;3790846;0.018014;quickSort
230800;43991295744;131071;4054688;4185759;3792546;0.018119;quickSort
230900;431037465744;131071;4056388;4187459;3794246;0.018072;quickSort
231000;431083655744;131071;4058088;4189159;3795946;0.018061;quickSort
231100;431129865744;131071;4059788;4190859;3797646;0.018044;quickSort
231200;431176095744;131071;4061488;4192559;3799346;0.018479;quickSort
231300;44006593552;131071;4063188;4194259;3801046;0.018656;quickSort
231400;44052863552;131071;4064888;4195959;3802746;0.018159;quickSort
231500;44099153552;131071;4066588;4197659;3804446;0.018112;quickSort
231600;44145463552;131071;4068288;4199359;3806146;0.018111;quickSort
231700;44191793552;131071;4069988;4201059;3807846;0.018085;quickSort
231800;44238143552;131071;4071688;4202759;3809546;0.018115;quickSort
231900;44284513552;131071;4073388;4204459;3811246;0.018121;quickSort
232000;44330903552;131071;4075088;4206159;3812946;0.018114;quickSort
232100;44377313552;131071;4076788;4207859;3814646;0.018143;quickSort
232200;44423743552;131071;4078488;4209559;3816346;0.018081;quickSort
232300;44470193552;131071;4080188;4211259;3818046;0.018135;quickSort
232400;44516663552;131071;4081888;4212959;3819746;0.018181;quickSort
232500;44563153552;131071;4083588;4214659;3821446;0.018093;quickSort
232600;44609663552;131071;4085288;4216359;3823146;0.018161;quickSort
232700;44656193552;131071;4086988;4218059;3824846;0.018153;quickSort
232800;44702743552;131071;4088688;4219759;3826546;0.018154;quickSort
232900;44749313552;131071;4090388;4221459;3828246;0.018172;quickSort
233000;44795903552;131071;4092088;4223159;3829946;0.018212;quickSort
233100;44842513552;131071;4093788;4224859;3831646;0.018197;quickSort
233200;44889143552;131071;4095488;4226559;3833346;0.018165;quickSort
233300;44935793552;131071;4097188;4228259;3835046;0.018206;quickSort
233400;44982463552;131071;4098888;4229959;3836746;0.018174;quickSort
233500;441029153552;131071;4100588;4231659;3838446;0.017759;quickSort
233600;441075863552;131071;4102288;4233359;3840146;0.017759;quickSort
233700;441122593552;131071;4103988;4235059;3841846;0.018236;quickSort
233800;441169343552;131071;4105688;4236759;3843546;0.018341;quickSort
233900;45000361360;131071;4107388;4238459;3845246;0.018296;quickSort
234000;45047151360;131071;4109088;4240159;3846946;0.018320;quickSort
234100;45093961360;131071;4110788;4241859;3848646;0.018265;quickSort
234200;45140791360;131071;4112488;4243559;3850346;0.018244;quickSort
234300;45187641360;131071;4114188;4245259;3852046;0.018314;quickSort
234400;45234511360;131071;4115888;4246959;3853746;0.019626;quickSort
234500;45281401360;131071;4117588;4248659;3855446;0.018284;quickSort
234600;45328311360;131071;4119288;4250359;3857146;0.018301;quickSort
234700;45375241360;131071;4120988;4252059;3858846;0.018311;quickSort
234800;45422191360;131071;4122688;4253759;3860546;0.018326;quickSort
234900;45469161360;131071;4124388;4255459;3862246;0.018300;quickSort
235000;45516151360;131071;4126088;4257159;3863946;0.018379;quickSort
235100;45563161360;131071;4127788;4258859;3865646;0.018361;quickSort
235200;45610191360;131071;4129488;4260559;3867346;0.018355;quickSort
235300;45657241360;131071;4131188;4262259;3869046;0.018314;quickSort
235400;45704311360;131071;4132888;4263959;3870746;0.018338;quickSort
235500;45751401360;131071;4134588;4265659;3872446;0.018334;quickSort
235600;45798511360;131071;4136288;4267359;3874146;0.018388;quickSort
235700;45845641360;131071;4137988;4269059;3875846;0.018410;quickSort
235800;45892791360;131071;4139688;4270759;3877546;0.018365;quickSort
235900;45939961360;131071;4141388;4272459;3879246;0.018378;quickSort
236000;45987151360;131071;4143088;4274159;3880946;0.018510;quickSort
236100;451034361360;131071;4144788;4275859;3882646;0.018887;quickSort
236200;451081591360;131071;4146488;4277559;3884346;0.018848;quickSort
236300;451128841360;131071;4148188;4279259;3886046;0.018627;quickSort
236400;451176111360;131071;4149888;4280959;3887746;0.018526;quickSort
236500;46007649168;131071;4151588;4282659;3889446;0.018523;quickSort
236600;46054959168;131071;4153288;4284359;3891146;0.018514;quickSort
236700;46102289168;131071;4154988;4286059;3892846;0.018506;quickSort
236800;46149639168;131071;4156688;4287759;3894546;0.018481;quickSort
236900;46197009168;131071;4158388;4289459;3896246;0.018473;quickSort
237000;46244399168;131071;4160088;4291159;3897946;0.019914;quickSort
237100;46291809168;131071;4161788;4292859;3899646;0.018933;quickSort
237200;46339239168;131071;4163488;4294559;3901346;0.018468;quickSort
237300;46386689168;131071;4165188;4296259;3903046;0.018471;quickSort
237400;46434159168;131071;4166888;4297959;3904746;0.018484;quickSort
237500;46481649168;131071;4168588;4299659;3906446;0.018482;quickSort
237600;46529159168;131071;4170288;4301359;3908146;0.018530;quickSort
237700;46576689168;131071;4171988;4303059;3909846;0.018585;quickSort
237800;46624239168;131071;4173688;4304759;3911546;0.018502;quickSort
238000;46719399168;131071;4177088;4308159;3914946;0.018804;quickSort
238100;46767009168;131071;4178788;4309859;3916646;0.018537;quickSort
238200;46814639168;131071;4180488;4311559;3918346;0.018860;quickSort
238300;46862289168;131071;4182188;4313259;3920046;0.019067;quickSort
238400;46909959168;131071;4183888;4314959;3921746;0.018577;quickSort
238500;46957649168;131071;4185588;4316659;3923446;0.018572;quickSort
238600;461005359168;131071;4187288;4318359;3925146;0.018534;quickSort
238700;461053089168;131071;4188988;4320059;3926846;0.018559;quickSort
238800;461100839168;131071;4190688;4321759;3928546;0.018548;quickSort
238900;461148609168;131071;4192388;4323459;3930246;0.018588;quickSort
239000;461196399168;131071;4194088;4325159;3931946;0.018900;quickSort
239100;47028456976;131071;4195788;4326859;3933646;0.018576;quickSort
239200;47076286976;131071;4197488;4328559;3935346;0.018580;quickSort
239300;47124136976;131071;4199188;4330259;3937046;0.019335;quickSort
239400;47172006976;131071;4200888;4331959;3938746;0.018586;quickSort
239500;47219896976;131071;4202588;4333659;3940446;0.018593;quickSort
239600;47267806976;131071;4204288;4335359;3942146;0.018642;quickSort
239700;47315736976;131071;4205988;4337059;3943846;0.018603;quickSort
239800;47363686976;131071;4207688;4338759;3945546;0.018615;quickSort
239900;47411656976;131071;4209388;4340459;3947246;0.018610;quickSort
240000;47459646976;131071;4211088;4342159;3948946;0.018610;quickSort
240100;47507656976;131071;4212788;4343859;3950646;0.018656;quickSort
240200;47555686976;131071;4214488;4345559;3952346;0.018647;quickSort
240300;47603736976;131071;4216188;4347259;3954046;0.018627;quickSort
240400;47651806976;131071;4217888;4348959;3955746;0.018685;quickSort
240500;47699896976;131071;4219588;4350659;3957446;0.018653;quickSort
240600;47748006976;131071;4221288;4352359;3959146;0.018672;quickSort
240700;47796136976;131071;4222988;4354059;3960846;0.018669;quickSort
240800;47844286976;131071;4224688;4355759;3962546;0.019024;quickSort
240900;47892456976;131071;4226388;4357459;3964246;0.020993;quickSort
241000;47940646976;131071;4228088;4359159;3965946;0.018632;quickSort
241100;47988856976;131071;4229788;4360859;3967646;0.018731;quickSort
241200;471037086976;131071;4231488;4362559;3969346;0.018676;quickSort
241300;471085336976;131071;4233188;4364259;3971046;0.018730;quickSort
241400;471133606976;131071;4234888;4365959;3972746;0.018751;quickSort
241500;471181896976;131071;4236588;4367659;3974446;0.018761;quickSort
241600;48014454784;131071;4238288;4369359;3976146;0.018735;quickSort
241700;48062784784;131071;4239988;4371059;3977846;0.018840;quickSort
241800;48111134784;131071;4241688;4372759;3979546;0.018870;quickSort
241900;48159504784;131071;4243388;4374459;3981246;0.018785;quickSort
242000;48207894784;131071;4245088;4376159;3982946;0.019108;quickSort
242100;48256304784;131071;4246788;4377859;3984646;0.018783;quickSort
242200;48304734784;131071;4248488;4379559;3986346;0.018776;quickSort
242300;48353184784;131071;4250188;4381259;3988046;0.018789;quickSort
242400;48401654784;131071;4251888;4382959;3989746;0.018817;quickSort
242500;48450144784;131071;4253588;4384659;3991446;0.018779;quickSort
242600;48498654784;131071;4255288;4386359;3993146;0.018881;quickSort
242700;48547184784;131071;4256988;4388059;3994846;0.018819;quickSort
242800;48595734784;131071;4258688;4389759;3996546;0.019059;quickSort
242900;48644304784;131071;4260388;4391459;3998246;0.019152;quickSort
243000;48692894784;131071;4262088;4393159;3999946;0.018964;quickSort
243100;48741504784;131071;4263788;4394859;4001646;0.018941;quickSort
243200;48790134784;131071;4265488;4396559;4003346;0.018952;quickSort
243300;48838784784;131071;4267188;4398259;4005046;0.018849;quickSort
243400;48887454784;131071;4268888;4399959;4006746;0.018992;quickSort
243500;48936144784;131071;4270588;4401659;4008446;0.018908;quickSort
243600;48984854784;131071;4272288;4403359;4010146;0.018887;quickSort
243700;481033584784;131071;4273988;4405059;4011846;0.018909;quickSort
243800;481082334784;131071;4275688;4406759;4013546;0.018917;quickSort
243900;481131104784;131071;4277388;4408459;4015246;0.018921;quickSort
244000;481179894784;131071;4279088;4410159;4016946;0.019018;quickSort
244100;49012952592;131071;4280788;4411859;4018646;0.018864;quickSort
244200;49061782592;131071;4282488;4413559;4020346;0.018902;quickSort
244300;49110632592;131071;4284188;4415259;4022046;0.018845;quickSort
244400;49159502592;131071;4285888;4416959;4023746;0.018909;quickSort
244500;49208392592;131071;4287588;4418659;4025446;0.018870;quickSort
244600;49257302592;131071;4289288;4420359;4027146;0.019539;quickSort
244700;49306232592;131071;4290988;4422059;4028846;0.020275;quickSort
244800;49355182592;131071;4292688;4423759;4030546;0.018557;quickSort
244900;49404152592;131071;4294388;4425459;4032246;0.018900;quickSort
245000;49453142592;131071;4296088;4427159;4033946;0.018865;quickSort
245100;49502152592;131071;4297788;4428859;4035646;0.018473;quickSort
245200;49551182592;131071;4299488;4430559;4037346;0.018462;quickSort
245300;49600232592;131071;4301188;4432259;4039046;0.018959;quickSort
245400;49649302592;131071;4302888;4433959;4040746;0.018814;quickSort
245500;49698392592;131071;4304588;4435659;4042446;0.018879;quickSort
245600;49747502592;131071;4306288;4437359;4044146;0.018959;quickSort
245700;49796632592;131071;4307988;4439059;4045846;0.019087;quickSort
245900;49894952592;131071;4311388;4442459;4049246;0.018918;quickSort
246000;49944142592;131071;4313088;4444159;4050946;0.019410;quickSort
246100;49993352592;131071;4314788;4445859;4052646;0.018979;quickSort
246200;491042582592;131071;4316488;4447559;4054346;0.018981;quickSort
246300;491091832592;131071;4318188;4449259;4056046;0.018984;quickSort
246400;491141102592;131071;4319888;4450959;4057746;0.019050;quickSort
246500;491190392592;131071;4321588;4452659;4059446;0.019033;quickSort
246600;50023950400;131071;4323288;4454359;4061146;0.019442;quickSort
246700;50073280400;131071;4324988;4456059;4062846;0.018679;quickSort
246800;50122630400;131071;4326688;4457759;4064546;0.018975;quickSort
246900;50172000400;131071;4328388;4459459;4066246;0.019104;quickSort
247000;50221390400;131071;4330088;4461159;4067946;0.019069;quickSort
247100;50270800400;131071;4331788;4462859;4069646;0.019097;quickSort
247200;50320230400;131071;4333488;4464559;4071346;0.019087;quickSort
247300;50369680400;131071;4335188;4466259;4073046;0.019075;quickSort
247400;50419150400;131071;4336888;4467959;4074746;0.019095;quickSort
247500;50468640400;131071;4338588;4469659;4076446;0.019136;quickSort
247600;50518150400;131071;4340288;4471359;4078146;0.019147;quickSort
247700;50567680400;131071;4341988;4473059;4079846;0.019393;quickSort
247800;50617230400;131071;4343688;4474759;4081546;0.019124;quickSort
247900;50666800400;131071;4345388;4476459;4083246;0.019135;quickSort
248000;50716390400;131071;4347088;4478159;4084946;0.019139;quickSort
248100;50766000400;131071;4348788;4479859;4086646;0.019119;quickSort
248200;50815630400;131071;4350488;4481559;4088346;0.020698;quickSort
248300;50865280400;131071;4352188;4483259;4090046;0.019314;quickSort
248400;50914950400;131071;4353888;4484959;4091746;0.019696;quickSort
248500;50964640400;131071;4355588;4486659;4093446;0.019603;quickSort
248600;501014350400;131071;4357288;4488359;4095146;0.019293;quickSort
248700;501064080400;131071;4358988;4490059;4096846;0.020268;quickSort
248800;501113830400;131071;4360688;4491759;4098546;0.020929;quickSort
248900;501163600400;131071;4362388;4493459;4100246;0.020750;quickSort
249000;501213390400;131071;4364088;4495159;4101946;0.021511;quickSort
249100;51047448208;131071;4365788;4496859;4103646;0.023449;quickSort
249200;51097278208;131071;4367488;4498559;4105346;0.020158;quickSort
249300;51147128208;131071;4369188;4500259;4107046;0.019572;quickSort
249400;51196998208;131071;4370888;4501959;4108746;0.019369;quickSort
249500;51246888208;131071;4372588;4503659;4110446;0.019337;quickSort
249600;51296798208;131071;4374288;4505359;4112146;0.019328;quickSort
249700;51346728208;131071;4375988;4507059;4113846;0.019203;quickSort
249800;51396678208;131071;4377688;4508759;4115546;0.020186;quickSort
249900;51446648208;131071;4379388;4510459;4117246;0.021309;quickSort
250000;51496638208;131071;4381088;4512159;4118946;0.019769;quickSort
250100;51546648208;131071;4382788;4513859;4120646;0.019809;quickSort
250200;51596678208;131071;4384488;4515559;4122346;0.020734;quickSort
250300;51646728208;131071;4386188;4517259;4124046;0.019291;quickSort
250400;51696798208;131071;4387888;4518959;4125746;0.020504;quickSort
250500;51746888208;131071;4389588;4520659;4127446;0.019560;quickSort
250600;51796998208;131071;4391288;4522359;4129146;0.019408;quickSort
250700;51847128208;131071;4392988;4524059;4130846;0.019139;quickSort
250800;51897278208;131071;4394688;4525759;4132546;0.019994;quickSort
250900;51947448208;131071;4396388;4527459;4134246;0.019323;quickSort
251000;51997638208;131071;4398088;4529159;4135946;0.019312;quickSort
251100;511047848208;131071;4399788;4530859;4137646;0.019356;quickSort
251200;511098078208;131071;4401488;4532559;4139346;0.019320;quickSort
251300;511148328208;131071;4403188;4534259;4141046;0.019392;quickSort
251400;511198598208;131071;4404888;4535959;4142746;0.019392;quickSort
251500;52033136016;131071;4406588;4537659;4144446;0.019420;quickSort
251600;52083446016;131071;4408288;4539359;4146146;0.019428;quickSort
251700;52133776016;131071;4409988;4541059;4147846;0.019615;quickSort
251800;52184126016;131071;4411688;4542759;4149546;0.019509;quickSort
251900;52234496016;131071;4413388;4544459;4151246;0.019475;quickSort
252000;52284886016;131071;4415088;4546159;4152946;0.019442;quickSort
252100;52335296016;131071;4416788;4547859;4154646;0.019424;quickSort
252200;52385726016;131071;4418488;4549559;4156346;0.019435;quickSort
252300;52436176016;131071;4420188;4551259;4158046;0.019452;quickSort
252400;52486646016;131071;4421888;4552959;4159746;0.018967;quickSort
252500;52537136016;131071;4423588;4554659;4161446;0.019463;quickSort
252600;52587646016;131071;4425288;4556359;4163146;0.019478;quickSort
252700;52638176016;131071;4426988;4558059;4164846;0.019778;quickSort
252800;52688726016;131071;4428688;4559759;4166546;0.019454;quickSort
252900;52739296016;131071;4430388;4561459;4168246;0.019316;quickSort
253000;52789886016;131071;4432088;4563159;4169946;0.019505;quickSort
253100;52840496016;131071;4433788;4564859;4171646;0.019530;quickSort
253200;52891126016;131071;4435488;4566559;4173346;0.019496;quickSort
253300;52941776016;131071;4437188;4568259;4175046;0.019520;quickSort
253400;52992446016;131071;4438888;4569959;4176746;0.020823;quickSort
253500;521043136016;131071;4440588;4571659;4178446;0.020999;quickSort
253600;521093846016;131071;4442288;4573359;4180146;0.019303;quickSort
253700;521144576016;131071;4443988;4575059;4181846;0.019667;quickSort
253800;521195326016;131071;4445688;4576759;4183546;0.019546;quickSort
253900;53030343824;131071;4447388;4578459;4185246;0.019511;quickSort
254000;53081133824;131071;4449088;4580159;4186946;0.019545;quickSort
254100;53131943824;131071;4450788;4581859;4188646;0.019563;quickSort
254200;53182773824;131071;4452488;4583559;4190346;0.019565;quickSort
254300;53233623824;131071;4454188;4585259;4192046;0.019623;quickSort
254400;53284493824;131071;4455888;4586959;4193746;0.019600;quickSort
254500;53335383824;131071;4457588;4588659;4195446;0.019648;quickSort
254600;53386293824;131071;4459288;4590359;4197146;0.019618;quickSort
254700;53437223824;131071;4460988;4592059;4198846;0.019583;quickSort
254800;53488173824;131071;4462688;4593759;4200546;0.019691;quickSort
254900;53539143824;131071;4464388;4595459;4202246;0.019856;quickSort
255000;53590133824;131071;4466088;4597159;4203946;0.019604;quickSort
255100;53641143824;131071;4467788;4598859;4205646;0.019683;quickSort
255200;53692173824;131071;4469488;4600559;4207346;0.019670;quickSort
255300;53743223824;131071;4471188;4602259;4209046;0.019678;quickSort
255400;53794293824;131071;4472888;4603959;4210746;0.019679;quickSort
255500;53845383824;131071;4474588;4605659;4212446;0.019690;quickSort
255600;53896493824;131071;4476288;4607359;4214146;0.019800;quickSort
255700;53947623824;131071;4477988;4609059;4215846;0.020020;quickSort
255800;53998773824;131071;4479688;4610759;4217546;0.019741;quickSort
255900;531049943824;131071;4481388;4612459;4219246;0.019793;quickSort
256000;531101133824;131071;4483088;4614159;4220946;0.019713;quickSort
256100;531152343824;131071;4484788;4615859;4222646;0.019722;quickSort
256200;531203573824;131071;4486488;4617559;4224346;0.019732;quickSort
256300;54039071632;131071;4488188;4619259;4226046;0.020533;quickSort
256400;54090341632;131071;4489888;4620959;4227746;0.019721;quickSort
256500;54141631632;131071;4491588;4622659;4229446;0.019755;quickSort
256600;54192941632;131071;4493288;4624359;4231146;0.019817;quickSort
256700;54244271632;131071;4494988;4626059;4232846;0.019710;quickSort
256800;54295621632;131071;4496688;4627759;4234546;0.019749;quickSort
256900;54346991632;131071;4498388;4629459;4236246;0.019762;quickSort
257000;54398381632;131071;4500088;4631159;4237946;0.019731;quickSort
257100;54449791632;131071;4501788;4632859;4239646;0.019819;quickSort
257200;54501221632;131071;4503488;4634559;4241346;0.019785;quickSort
257300;54552671632;131071;4505188;4636259;4243046;0.019731;quickSort
257400;54604141632;131071;4506888;4637959;4244746;0.019739;quickSort
257500;54655631632;131071;4508588;4639659;4246446;0.019764;quickSort
257700;54758671632;131071;4511988;4643059;4249846;0.019286;quickSort
257800;54810221632;131071;4513688;4644759;4251546;0.019740;quickSort
257900;54861791632;131071;4515388;4646459;4253246;0.019936;quickSort
258000;54913381632;131071;4517088;4648159;4254946;0.019821;quickSort
258100;54964991632;131071;4518788;4649859;4256646;0.019481;quickSort
258200;541016621632;131071;4520488;4651559;4258346;0.019825;quickSort
258300;541068271632;131071;4522188;4653259;4260046;0.020745;quickSort
258400;541119941632;131071;4523888;4654959;4261746;0.021369;quickSort
258500;541171631632;131071;4525588;4656659;4263446;0.019908;quickSort
258600;55007589440;131071;4527288;4658359;4265146;0.019871;quickSort
258700;55059319440;131071;4528988;4660059;4266846;0.019434;quickSort
258800;55111069440;131071;4530688;4661759;4268546;0.019360;quickSort
258900;55162839440;131071;4532388;4663459;4270246;0.019844;quickSort
259000;55214629440;131071;4534088;4665159;4271946;0.019848;quickSort
259100;55266439440;131071;4535788;4666859;4273646;0.019900;quickSort
259200;55318269440;131071;4537488;4668559;4275346;0.019840;quickSort
259300;55370119440;131071;4539188;4670259;4277046;0.019940;quickSort
259400;55421989440;131071;4540888;4671959;4278746;0.019907;quickSort
259500;55473879440;131071;4542588;4673659;4280446;0.019891;quickSort
259600;55525789440;131071;4544288;4675359;4282146;0.020832;quickSort
259700;55577719440;131071;4545988;4677059;4283846;0.019854;quickSort
259800;55629669440;131071;4547688;4678759;4285546;0.019872;quickSort
259900;55681639440;131071;4549388;4680459;4287246;0.019909;quickSort
260000;55733629440;131071;4551088;4682159;4288946;0.019854;quickSort
260100;55785639440;131071;4552788;4683859;4290646;0.019923;quickSort
260200;55837669440;131071;4554488;4685559;4292346;0.020029;quickSort
260300;55889719440;131071;4556188;4687259;4294046;0.019909;quickSort
260400;55941789440;131071;4557888;4688959;4295746;0.020089;quickSort
260500;55993879440;131071;4559588;4690659;4297446;0.020033;quickSort
260600;551045989440;131071;4561288;4692359;4299146;0.019991;quickSort
260700;551098119440;131071;4562988;4694059;4300846;0.020420;quickSort
260800;551150269440;131071;4564688;4695759;4302546;0.019499;quickSort
260900;551202439440;131071;4566388;4697459;4304246;0.019469;quickSort
261000;56038877248;131071;4568088;4699159;4305946;0.019944;quickSort
261100;56091087248;131071;4569788;4700859;4307646;0.019979;quickSort
261200;56143317248;131071;4571488;4702559;4309346;0.019950;quickSort
261300;56195567248;131071;4573188;4704259;4311046;0.019977;quickSort
261400;56247837248;131071;4574888;4705959;4312746;0.020024;quickSort
261500;56300127248;131071;4576588;4707659;4314446;0.019962;quickSort
261600;56352437248;131071;4578288;4709359;4316146;0.019966;quickSort
261700;56404767248;131071;4579988;4711059;4317846;0.019967;quickSort
261800;56457117248;131071;4581688;4712759;4319546;0.019974;quickSort
261900;56509487248;131071;4583388;4714459;4321246;0.019966;quickSort
262000;56561877248;131071;4585088;4716159;4322946;0.019994;quickSort
262100;56614287248;131071;4586788;4717859;4324646;0.019997;quickSort
262200;56666717248;131128;4588716;4719844;4326460;0.020044;quickSort
262300;56719167248;131228;4590816;4722044;4328360;0.020060;quickSort
262500;56824127248;131428;4595016;4726444;4332160;0.020107;quickSort
262600;56876637248;131528;4597116;4728644;4334060;0.020104;quickSort
262700;56929167248;131628;4599216;4730844;4335960;0.020035;quickSort
262800;56981717248;131728;4601316;4733044;4337860;0.020084;quickSort
262900;561034287248;131828;4603416;4735244;4339760;0.020105;quickSort
263000;561086877248;131928;4605516;4737444;4341660;0.020215;quickSort
263100;561139487248;132028;4607616;4739644;4343560;0.020087;quickSort
263200;561192117248;132128;4609716;4741844;4345460;0.020115;quickSort
263300;57029015056;132228;4611816;4744044;4347360;0.020132;quickSort
263400;57081685056;132328;4613916;4746244;4349260;0.020205;quickSort
263500;57134375056;132428;4616016;4748444;4351160;0.020194;quickSort
263600;57187085056;132528;4618116;4750644;4353060;0.020171;quickSort
263700;57239815056;132628;4620216;4752844;4354960;0.020145;quickSort
263800;57292565056;132728;4622316;4755044;4356860;0.020201;quickSort
263900;57345335056;132828;4624416;4757244;4358760;0.020275;quickSort
264000;57398125056;132928;4626516;4759444;4360660;0.020263;quickSort
264100;57450935056;133028;4628616;4761644;4362560;0.020239;quickSort
264200;57503765056;133128;4630716;4763844;4364460;0.020269;quickSort
264300;57556615056;133228;4632816;4766044;4366360;0.020351;quickSort
264400;57609485056;133328;4634916;4768244;4368260;0.020363;quickSort
264500;57662375056;133428;4637016;4770444;4370160;0.019897;quickSort
264600;57715285056;133528;4639116;4772644;4372060;0.020936;quickSort
264700;57768215056;133628;4641216;4774844;4373960;0.020318;quickSort
264800;57821165056;133728;4643316;4777044;4375860;0.021584;quickSort
264900;57874135056;133828;4645416;4779244;4377760;0.020372;quickSort
265000;57927125056;133928;4647516;4781444;4379660;0.020378;quickSort
265100;57980135056;134028;4649616;4783644;4381560;0.020398;quickSort
265200;571033165056;134128;4651716;4785844;4383460;0.020384;quickSort
265300;571086215056;134228;4653816;4788044;4385360;0.020532;quickSort
265400;571139285056;134328;4655916;4790244;4387260;0.020454;quickSort
265500;571192375056;134428;4658016;4792444;4389160;0.020481;quickSort
265600;58029732864;134528;4660116;4794644;4391060;0.020479;quickSort
265700;58082862864;134628;4662216;4796844;4392960;0.020503;quickSort
265800;58136012864;134728;4664316;4799044;4394860;0.020549;quickSort
265900;58189182864;134828;4666416;4801244;4396760;0.020514;quickSort
266000;58242372864;134928;4668516;4803444;4398660;0.020542;quickSort
266100;58295582864;135028;4670616;4805644;4400560;0.020595;quickSort
266200;58348812864;135128;4672716;4807844;4402460;0.020498;quickSort
266300;58402062864;135228;4674816;4810044;4404360;0.020882;quickSort
266400;58455332864;135328;4676916;4812244;4406260;0.020573;quickSort
266500;58508622864;135428;4679016;4814444;4408160;0.020586;quickSort
266600;58561932864;135528;4681116;4816644;4410060;0.020555;quickSort
266700;58615262864;135628;4683216;4818844;4411960;0.020655;quickSort
266800;58668612864;135728;4685316;4821044;4413860;0.020637;quickSort
266900;58721982864;135828;4687416;4823244;4415760;0.020576;quickSort
267000;58775372864;135928;4689516;4825444;4417660;0.020592;quickSort
267100;58828782864;136028;4691616;4827644;4419560;0.020694;quickSort
267200;58882212864;136128;4693716;4829844;4421460;0.020600;quickSort
267300;58935662864;136228;4695816;4832044;4423360;0.020616;quickSort
267400;58989132864;136328;4697916;4834244;4425260;0.020651;quickSort
267500;581042622864;136428;4700016;4836444;4427160;0.020617;quickSort
267600;581096132864;136528;4702116;4838644;4429060;0.020670;quickSort
267700;581149662864;136628;4704216;4840844;4430960;0.020674;quickSort
267800;581203212864;136728;4706316;4843044;4432860;0.021912;quickSort
267900;59041030672;136828;4708416;4845244;4434760;0.020757;quickSort
268000;59094620672;136928;4710516;4847444;4436660;0.020732;quickSort
268100;59148230672;137028;4712616;4849644;4438560;0.020727;quickSort
268200;59201860672;137128;4714716;4851844;4440460;0.020764;quickSort
268300;59255510672;137228;4716816;4854044;4442360;0.022974;quickSort
268400;59309180672;137328;4718916;4856244;4444260;0.020772;quickSort
268500;59362870672;137428;4721016;4858444;4446160;0.020880;quickSort
268600;59416580672;137528;4723116;4860644;4448060;0.020768;quickSort
268700;59470310672;137628;4725216;4862844;4449960;0.020724;quickSort
268800;59524060672;137728;4727316;4865044;4451860;0.020983;quickSort
268900;59577830672;137828;4729416;4867244;4453760;0.020791;quickSort
269000;59631620672;137928;4731516;4869444;4455660;0.020770;quickSort
269100;59685430672;138028;4733616;4871644;4457560;0.020834;quickSort
269200;59739260672;138128;4735716;4873844;4459460;0.020836;quickSort
269300;59793110672;138228;4737816;4876044;4461360;0.020803;quickSort
269400;59846980672;138328;4739916;4878244;4463260;0.021053;quickSort
269500;59900870672;138428;4742016;4880444;4465160;0.020915;quickSort
269600;59954780672;138528;4744116;4882644;4467060;0.020856;quickSort
269700;591008710672;138628;4746216;4884844;4468960;0.020920;quickSort
269800;591062660672;138728;4748316;4887044;4470860;0.020940;quickSort
269900;591116630672;138828;4750416;4889244;4472760;0.021278;quickSort
270000;591170620672;138928;4752516;4891444;4474660;0.020986;quickSort
270100;60008878480;139028;4754616;4893644;4476560;0.020912;quickSort
270200;60062908480;139128;4756716;4895844;4478460;0.020954;quickSort
270300;60116958480;139228;4758816;4898044;4480360;0.020926;quickSort
270400;60171028480;139328;4760916;4900244;4482260;0.020980;quickSort
270500;60225118480;139428;4763016;4902444;4484160;0.020985;quickSort
270600;60279228480;139528;4765116;4904644;4486060;0.021033;quickSort
270700;60333358480;139628;4767216;4906844;4487960;0.021216;quickSort
270800;60387508480;139728;4769316;4909044;4489860;0.021043;quickSort
270900;60441678480;139828;4771416;4911244;4491760;0.021369;quickSort
271000;60495868480;139928;4773516;4913444;4493660;0.021187;quickSort
271100;60550078480;140028;4775616;4915644;4495560;0.021260;quickSort
271200;60604308480;140128;4777716;4917844;4497460;0.021658;quickSort
271300;60658558480;140228;4779816;4920044;4499360;0.021385;quickSort
271400;60712828480;140328;4781916;4922244;4501260;0.021143;quickSort
271500;60767118480;140428;4784016;4924444;4503160;0.021414;quickSort
271600;60821428480;140528;4786116;4926644;4505060;0.021524;quickSort
271700;60875758480;140628;4788216;4928844;4506960;0.021639;quickSort
271800;60930108480;140728;4790316;4931044;4508860;0.021491;quickSort
271900;60984478480;140828;4792416;4933244;4510760;0.021398;quickSort
272000;601038868480;140928;4794516;4935444;4512660;0.021338;quickSort
272100;601093278480;141028;4796616;4937644;4514560;0.021521;quickSort
272200;601147708480;141128;4798716;4939844;4516460;0.021546;quickSort
272300;601202158480;141228;4800816;4942044;4518360;0.022129;quickSort
272400;61040876288;141328;4802916;4944244;4520260;0.021454;quickSort
272500;61095366288;141428;4805016;4946444;4522160;0.021174;quickSort
272600;61149876288;141528;4807116;4948644;4524060;0.021204;quickSort
272700;61204406288;141628;4809216;4950844;4525960;0.021243;quickSort
272800;61258956288;141728;4811316;4953044;4527860;0.021284;quickSort
272900;61313526288;141828;4813416;4955244;4529760;0.021291;quickSort
273000;61368116288;141928;4815516;4957444;4531660;0.021337;quickSort
273100;61422726288;142028;4817616;4959644;4533560;0.021909;quickSort
273200;61477356288;142128;4819716;4961844;4535460;0.021559;quickSort
273300;61532006288;142228;4821816;4964044;4537360;0.021266;quickSort
273400;61586676288;142328;4823916;4966244;4539260;0.021293;quickSort
273500;61641366288;142428;4826016;4968444;4541160;0.021346;quickSort
273600;61696076288;142528;4828116;4970644;4543060;0.021365;quickSort
273700;61750806288;142628;4830216;4972844;4544960;0.021363;quickSort
273800;61805556288;142728;4832316;4975044;4546860;0.021312;quickSort
273900;61860326288;142828;4834416;4977244;4548760;0.020819;quickSort
274000;61915116288;142928;4836516;4979444;4550660;0.020911;quickSort
274100;61969926288;143028;4838616;4981644;4552560;0.021292;quickSort
274200;611024756288;143128;4840716;4983844;4554460;0.021408;quickSort
274300;611079606288;143228;4842816;4986044;4556360;0.021413;quickSort
274400;611134476288;143328;4844916;4988244;4558260;0.021375;quickSort
274500;611189366288;143428;4847016;4990444;4560160;0.021457;quickSort
274600;62028524096;143528;4849116;4992644;4562060;0.020893;quickSort
274700;62083454096;143628;4851216;4994844;4563960;0.020933;quickSort
274800;62138404096;143728;4853316;4997044;4565860;0.021524;quickSort
274900;62193374096;143828;4855416;4999244;4567760;0.021545;quickSort
275000;62248364096;143928;4857516;5001444;4569660;0.021620;quickSort
275100;62303374096;144028;4859616;5003644;4571560;0.021840;quickSort
275200;62358404096;144128;4861716;5005844;4573460;0.021511;quickSort
275300;62413454096;144228;4863816;5008044;4575360;0.021538;quickSort
275400;62468524096;144328;4865916;5010244;4577260;0.021526;quickSort
275500;62523614096;144428;4868016;5012444;4579160;0.021481;quickSort
275600;62578724096;144528;4870116;5014644;4581060;0.021546;quickSort
275700;62633854096;144628;4872216;5016844;4582960;0.022205;quickSort
275800;62689004096;144728;4874316;5019044;4584860;0.023079;quickSort
275900;62744174096;144828;4876416;5021244;4586760;0.021639;quickSort
276000;62799364096;144928;4878516;5023444;4588660;0.021041;quickSort
276100;62854574096;145028;4880616;5025644;4590560;0.021289;quickSort
276200;62909804096;145128;4882716;5027844;4592460;0.021930;quickSort
276300;62965054096;145228;4884816;5030044;4594360;0.021624;quickSort
276400;621020324096;145328;4886916;5032244;4596260;0.021645;quickSort
276500;621075614096;145428;4889016;5034444;4598160;0.022145;quickSort
276600;621130924096;145528;4891116;5036644;4600060;0.021684;quickSort
276700;621186254096;145628;4893216;5038844;4601960;0.021686;quickSort
276800;63025851904;145728;4895316;5041044;4603860;0.021729;quickSort
276900;63081221904;145828;4897416;5043244;4605760;0.021651;quickSort
277000;63136611904;145928;4899516;5045444;4607660;0.021647;quickSort
277100;63192021904;146028;4901616;5047644;4609560;0.021704;quickSort
277200;63247451904;146128;4903716;5049844;4611460;0.021707;quickSort
277300;63302901904;146228;4905816;5052044;4613360;0.021742;quickSort
277400;63358371904;146328;4907916;5054244;4615260;0.022935;quickSort
277500;63413861904;146428;4910016;5056444;4617160;0.022595;quickSort
277600;63469371904;146528;4912116;5058644;4619060;0.021836;quickSort
277700;63524901904;146628;4914216;5060844;4620960;0.021899;quickSort
277800;63580451904;146728;4916316;5063044;4622860;0.022270;quickSort
277900;63636021904;146828;4918416;5065244;4624760;0.021869;quickSort
278000;63691611904;146928;4920516;5067444;4626660;0.021747;quickSort
278100;63747221904;147028;4922616;5069644;4628560;0.021758;quickSort
278200;63802851904;147128;4924716;5071844;4630460;0.021809;quickSort
278300;63858501904;147228;4926816;5074044;4632360;0.021886;quickSort
278400;63914171904;147328;4928916;5076244;4634260;0.021810;quickSort
278500;63969861904;147428;4931016;5078444;4636160;0.021848;quickSort
278600;631025571904;147528;4933116;5080644;4638060;0.021808;quickSort
278700;631081301904;147628;4935216;5082844;4639960;0.021840;quickSort
278800;631137051904;147728;4937316;5085044;4641860;0.021811;quickSort
278900;631192821904;147828;4939416;5087244;4643760;0.021867;quickSort
279000;64032859712;147928;4941516;5089444;4645660;0.021882;quickSort
279100;64088669712;148028;4943616;5091644;4647560;0.022263;quickSort
279200;64144499712;148128;4945716;5093844;4649460;0.021879;quickSort
279300;64200349712;148228;4947816;5096044;4651360;0.021918;quickSort
279400;64256219712;148328;4949916;5098244;4653260;0.021869;quickSort
279500;64312109712;148428;4952016;5100444;4655160;0.021808;quickSort
279600;64368019712;148528;4954116;5102644;4657060;0.021336;quickSort
279700;64423949712;148628;4956216;5104844;4658960;0.021688;quickSort
279800;64479899712;148728;4958316;5107044;4660860;0.021906;quickSort
279900;64535869712;148828;4960416;5109244;4662760;0.021922;quickSort
280000;64591859712;148928;4962516;5111444;4664660;0.021870;quickSort
280100;64647869712;149028;4964616;5113644;4666560;0.021914;quickSort
280200;64703899712;149128;4966716;5115844;4668460;0.021951;quickSort
280300;64759949712;149228;4968816;5118044;4670360;0.022268;quickSort
280400;64816019712;149328;4970916;5120244;4672260;0.022237;quickSort
280500;64872109712;149428;4973016;5122444;4674160;0.022304;quickSort
280600;64928219712;149528;4975116;5124644;4676060;0.022042;quickSort
280700;64984349712;149628;4977216;5126844;4677960;0.022058;quickSort
280800;641040499712;149728;4979316;5129044;4679860;0.021990;quickSort
280900;641096669712;149828;4981416;5131244;4681760;0.022085;quickSort
281000;641152859712;149928;4983516;5133444;4683660;0.022041;quickSort
281100;641209069712;150028;4985616;5135644;4685560;0.022134;quickSort
281200;65049547520;150128;4987716;5137844;4687460;0.022135;quickSort
281300;65105797520;150228;4989816;5140044;4689360;0.022091;quickSort
281400;65162067520;150328;4991916;5142244;4691260;0.022119;quickSort
281500;65218357520;150428;4994016;5144444;4693160;0.022113;quickSort
281600;65274667520;150528;4996116;5146644;4695060;0.022114;quickSort
281700;65330997520;150628;4998216;5148844;4696960;0.022136;quickSort
281800;65387347520;150728;5000316;5151044;4698860;0.022158;quickSort
281900;65443717520;150828;5002416;5153244;4700760;0.022139;quickSort
282000;65500107520;150928;5004516;5155444;4702660;0.022166;quickSort
282100;65556517520;151028;5006616;5157644;4704560;0.022130;quickSort
282200;65612947520;151128;5008716;5159844;4706460;0.022160;quickSort
282300;65669397520;151228;5010816;5162044;4708360;0.022171;quickSort
282400;65725867520;151328;5012916;5164244;4710260;0.022465;quickSort
282500;65782357520;151428;5015016;5166444;4712160;0.022382;quickSort
282600;65838867520;151528;5017116;5168644;4714060;0.022168;quickSort
282700;65895397520;151628;5019216;5170844;4715960;0.022160;quickSort
282800;65951947520;151728;5021316;5173044;4717860;0.022302;quickSort
282900;651008517520;151828;5023416;5175244;4719760;0.022257;quickSort
283000;651065107520;151928;5025516;5177444;4721660;0.022261;quickSort
283100;651121717520;152028;5027616;5179644;4723560;0.022296;quickSort
283200;651178347520;152128;5029716;5181844;4725460;0.022256;quickSort
283300;66019245328;152228;5031816;5184044;4727360;0.022391;quickSort
283400;66075915328;152328;5033916;5186244;4729260;0.022247;quickSort
283500;66132605328;152428;5036016;5188444;4731160;0.022244;quickSort
283600;66189315328;152528;5038116;5190644;4733060;0.022353;quickSort
283700;66246045328;152628;5040216;5192844;4734960;0.022392;quickSort
283800;66302795328;152728;5042316;5195044;4736860;0.022371;quickSort
283900;66359565328;152828;5044416;5197244;4738760;0.022839;quickSort
284000;66416355328;152928;5046516;5199444;4740660;0.022841;quickSort
284100;66473165328;153028;5048616;5201644;4742560;0.023165;quickSort
284200;66529995328;153128;5050716;5203844;4744460;0.022869;quickSort
284300;66586845328;153228;5052816;5206044;4746360;0.022742;quickSort
284400;66643715328;153328;5054916;5208244;4748260;0.022920;quickSort
284500;66700605328;153428;5057016;5210444;4750160;0.022372;quickSort
284600;66757515328;153528;5059116;5212644;4752060;0.022568;quickSort
284700;66814445328;153628;5061216;5214844;4753960;0.022388;quickSort
284800;66871395328;153728;5063316;5217044;4755860;0.022562;quickSort
284900;66928365328;153828;5065416;5219244;4757760;0.022541;quickSort
285000;66985355328;153928;5067516;5221444;4759660;0.022616;quickSort
285100;661042365328;154028;5069616;5223644;4761560;0.022559;quickSort
285200;661099395328;154128;5071716;5225844;4763460;0.022531;quickSort
285300;661156445328;154228;5073816;5228044;4765360;0.022433;quickSort
285500;67054853136;154428;5078016;5232444;4769160;0.022539;quickSort
285600;67111963136;154528;5080116;5234644;4771060;0.022520;quickSort
285700;67169093136;154628;5082216;5236844;4772960;0.022572;quickSort
285800;67226243136;154728;5084316;5239044;4774860;0.024178;quickSort
285900;67283413136;154828;5086416;5241244;4776760;0.022538;quickSort
286000;67340603136;154928;5088516;5243444;4778660;0.022529;quickSort
286100;67397813136;155028;5090616;5245644;4780560;0.022623;quickSort
286200;67455043136;155128;5092716;5247844;4782460;0.022519;quickSort
286300;67512293136;155228;5094816;5250044;4784360;0.022572;quickSort
286400;67569563136;155328;5096916;5252244;4786260;0.022610;quickSort
286500;67626853136;155428;5099016;5254444;4788160;0.022628;quickSort
286600;67684163136;155528;5101116;5256644;4790060;0.022676;quickSort
286700;67741493136;155628;5103216;5258844;4791960;0.022620;quickSort
286800;67798843136;155728;5105316;5261044;4793860;0.022612;quickSort
286900;67856213136;155828;5107416;5263244;4795760;0.023139;quickSort
287000;67913603136;155928;5109516;5265444;4797660;0.022905;quickSort
287100;67971013136;156028;5111616;5267644;4799560;0.022647;quickSort
287200;671028443136;156128;5113716;5269844;4801460;0.022674;quickSort
287300;671085893136;156228;5115816;5272044;4803360;0.022644;quickSort
287400;671143363136;156328;5117916;5274244;4805260;0.022701;quickSort
287500;671200853136;156428;5120016;5276444;4807160;0.022677;quickSort
287600;68042610944;156528;5122116;5278644;4809060;0.022710;quickSort
287700;68100140944;156628;5124216;5280844;4810960;0.023744;quickSort
287800;68157690944;156728;5126316;5283044;4812860;0.022835;quickSort
287900;68215260944;156828;5128416;5285244;4814760;0.022850;quickSort
288000;68272850944;156928;5130516;5287444;4816660;0.022782;quickSort
288100;68330460944;157028;5132616;5289644;4818560;0.022823;quickSort
288200;68388090944;157128;5134716;5291844;4820460;0.022758;quickSort
288300;68445740944;157228;5136816;5294044;4822360;0.022785;quickSort
288400;68503410944;157328;5138916;5296244;4824260;0.022813;quickSort
288500;68561100944;157428;5141016;5298444;4826160;0.022768;quickSort
288600;68618810944;157528;5143116;5300644;4828060;0.022869;quickSort
288700;68676540944;157628;5145216;5302844;4829960;0.022804;quickSort
288800;68734290944;157728;5147316;5305044;4831860;0.022771;quickSort
288900;68792060944;157828;5149416;5307244;4833760;0.022831;quickSort
289000;68849850944;157928;5151516;5309444;4835660;0.022864;quickSort
289100;68907660944;158028;5153616;5311644;4837560;0.022870;quickSort
289200;68965490944;158128;5155716;5313844;4839460;0.022804;quickSort
289300;681023340944;158228;5157816;5316044;4841360;0.022866;quickSort
289400;681081210944;158328;5159916;5318244;4843260;0.022890;quickSort
289500;681139100944;158428;5162016;5320444;4845160;0.022871;quickSort
289600;681197010944;158528;5164116;5322644;4847060;0.022956;quickSort
289700;69039188752;158628;5166216;5324844;4848960;0.022863;quickSort
289800;69097138752;158728;5168316;5327044;4850860;0.022976;quickSort
289900;69155108752;158828;5170416;5329244;4852760;0.022952;quickSort
290000;69213098752;158928;5172516;5331444;4854660;0.022968;quickSort
290100;69271108752;159028;5174616;5333644;4856560;0.022958;quickSort
290200;69329138752;159128;5176716;5335844;4858460;0.023027;quickSort
290300;69387188752;159228;5178816;5338044;4860360;0.022964;quickSort
290400;69445258752;159328;5180916;5340244;4862260;0.022977;quickSort
290500;69503348752;159428;5183016;5342444;4864160;0.022914;quickSort
290600;69561458752;159528;5185116;5344644;4866060;0.022989;quickSort
290700;69619588752;159628;5187216;5346844;4867960;0.023008;quickSort
290800;69677738752;159728;5189316;5349044;4869860;0.023010;quickSort
290900;69735908752;159828;5191416;5351244;4871760;0.023019;quickSort
291000;69794098752;159928;5193516;5353444;4873660;0.023027;quickSort
291100;69852308752;160028;5195616;5355644;4875560;0.023061;quickSort
291200;69910538752;160128;5197716;5357844;4877460;0.023304;quickSort
291300;69968788752;160228;5199816;5360044;4879360;0.023160;quickSort
291400;691027058752;160328;5201916;5362244;4881260;0.023043;quickSort
291500;691085348752;160428;5204016;5364444;4883160;0.023063;quickSort
291600;691143658752;160528;5206116;5366644;4885060;0.023026;quickSort
291700;691201988752;160628;5208216;5368844;4886960;0.023716;quickSort
291800;70044586560;160728;5210316;5371044;4888860;0.023184;quickSort
291900;70102956560;160828;5212416;5373244;4890760;0.023787;quickSort
292000;70161346560;160928;5214516;5375444;4892660;0.023397;quickSort
292100;70219756560;161028;5216616;5377644;4894560;0.023557;quickSort
292200;70278186560;161128;5218716;5379844;4896460;0.023089;quickSort
292300;70336636560;161228;5220816;5382044;4898360;0.023108;quickSort
292400;70395106560;161328;5222916;5384244;4900260;0.023092;quickSort
292500;70453596560;161428;5225016;5386444;4902160;0.023142;quickSort
292600;70512106560;161528;5227116;5388644;4904060;0.023387;quickSort
292700;70570636560;161628;5229216;5390844;4905960;0.023074;quickSort
292800;70629186560;161728;5231316;5393044;4907860;0.023103;quickSort
292900;70687756560;161828;5233416;5395244;4909760;0.023187;quickSort
293000;70746346560;161928;5235516;5397444;4911660;0.023169;quickSort
293100;70804956560;162028;5237616;5399644;4913560;0.023134;quickSort
293200;70863586560;162128;5239716;5401844;4915460;0.023182;quickSort
293300;70922236560;162228;5241816;5404044;4917360;0.023224;quickSort
293400;70980906560;162328;5243916;5406244;4919260;0.023169;quickSort
293500;701039596560;162428;5246016;5408444;4921160;0.023166;quickSort
293600;701098306560;162528;5248116;5410644;4923060;0.023197;quickSort
293700;701157036560;162628;5250216;5412844;4924960;0.023226;quickSort
293800;71000034368;162728;5252316;5415044;4926860;0.023220;quickSort
293900;71058804368;162828;5254416;5417244;4928760;0.023240;quickSort
294000;71117594368;162928;5256516;5419444;4930660;0.022655;quickSort
294100;71176404368;163028;5258616;5421644;4932560;0.022652;quickSort
294200;71235234368;163128;5260716;5423844;4934460;0.022954;quickSort
294300;71294084368;163228;5262816;5426044;4936360;0.023430;quickSort
294400;71352954368;163328;5264916;5428244;4938260;0.023295;quickSort
294500;71411844368;163428;5267016;5430444;4940160;0.023300;quickSort
294600;71470754368;163528;5269116;5432644;4942060;0.023394;quickSort
294700;71529684368;163628;5271216;5434844;4943960;0.023324;quickSort
294800;71588634368;163728;5273316;5437044;4945860;0.023313;quickSort
294900;71647604368;163828;5275416;5439244;4947760;0.023349;quickSort
295000;71706594368;163928;5277516;5441444;4949660;0.023368;quickSort
295100;71765604368;164028;5279616;5443644;4951560;0.023328;quickSort
295200;71824634368;164128;5281716;5445844;4953460;0.023295;quickSort
295300;71883684368;164228;5283816;5448044;4955360;0.023362;quickSort
295400;71942754368;164328;5285916;5450244;4957260;0.023364;quickSort
295500;711001844368;164428;5288016;5452444;4959160;0.023335;quickSort
295600;711060954368;164528;5290116;5454644;4961060;0.023363;quickSort
295700;711120084368;164628;5292216;5456844;4962960;0.023544;quickSort
295800;711179234368;164728;5294316;5459044;4964860;0.023434;quickSort
295900;72022652176;164828;5296416;5461244;4966760;0.023533;quickSort
296000;72081842176;164928;5298516;5463444;4968660;0.023390;quickSort
296100;72141052176;165028;5300616;5465644;4970560;0.023504;quickSort
296200;72200282176;165128;5302716;5467844;4972460;0.022877;quickSort
296300;72259532176;165228;5304816;5470044;4974360;0.022868;quickSort
296400;72318802176;165328;5306916;5472244;4976260;0.023184;quickSort
296500;72378092176;165428;5309016;5474444;4978160;0.023482;quickSort
296600;72437402176;165528;5311116;5476644;4980060;0.024091;quickSort
296700;72496732176;165628;5313216;5478844;4981960;0.027933;quickSort
296800;72556082176;165728;5315316;5481044;4983860;0.023534;quickSort
296900;72615452176;165828;5317416;5483244;4985760;0.024933;quickSort
297000;72674842176;165928;5319516;5485444;4987660;0.023534;quickSort
297100;72734252176;166028;5321616;5487644;4989560;0.023561;quickSort
297200;72793682176;166128;5323716;5489844;4991460;0.023511;quickSort
297300;72853132176;166228;5325816;5492044;4993360;0.023537;quickSort
297400;72912602176;166328;5327916;5494244;4995260;0.023597;quickSort
297500;72972092176;166428;5330016;5496444;4997160;0.023669;quickSort
297600;721031602176;166528;5332116;5498644;4999060;0.023578;quickSort
297700;721091132176;166628;5334216;5500844;5000960;0.023577;quickSort
297800;721150682176;166728;5336316;5503044;5002860;0.023572;quickSort
297900;721210252176;166828;5338416;5505244;5004760;0.023610;quickSort
298100;73113699984;167028;5342616;5509644;5008560;0.023658;quickSort
298200;73173329984;167128;5344716;5511844;5010460;0.023641;quickSort
298300;73232979984;167228;5346816;5514044;5012360;0.023797;quickSort
298400;73292649984;167328;5348916;5516244;5014260;0.023072;quickSort
298500;73352339984;167428;5351016;5518444;5016160;0.023144;quickSort
298600;73412049984;167528;5353116;5520644;5018060;0.023693;quickSort
298700;73471779984;167628;5355216;5522844;5019960;0.023749;quickSort
298800;73531529984;167728;5357316;5525044;5021860;0.023817;quickSort
298900;73591299984;167828;5359416;5527244;5023760;0.023979;quickSort
299000;73651089984;167928;5361516;5529444;5025660;0.023883;quickSort
299100;73710899984;168028;5363616;5531644;5027560;0.024031;quickSort
299200;73770729984;168128;5365716;5533844;5029460;0.023740;quickSort
299300;73830579984;168228;5367816;5536044;5031360;0.023774;quickSort
299400;73890449984;168328;5369916;5538244;5033260;0.023734;quickSort
299500;73950339984;168428;5372016;5540444;5035160;0.023810;quickSort
299600;731010249984;168528;5374116;5542644;5037060;0.023789;quickSort
299700;731070179984;168628;5376216;5544844;5038960;0.023829;quickSort
299800;731130129984;168728;5378316;5547044;5040860;0.023862;quickSort
299900;731190099984;168828;5380416;5549244;5042760;0.025203;quickSort
300000;74034337792;168928;5382516;5551444;5044660;0.024388;quickSort
300100;74094347792;169028;5384616;5553644;5046560;0.024362;quickSort
300200;74154377792;169128;5386716;5555844;5048460;0.025975;quickSort
300300;74214427792;169228;5388816;5558044;5050360;0.023846;quickSort
300400;74274497792;169328;5390916;5560244;5052260;0.023891;quickSort
300500;74334587792;169428;5393016;5562444;5054160;0.023953;quickSort
300600;74394697792;169528;5395116;5564644;5056060;0.023926;quickSort
300700;74454827792;169628;5397216;5566844;5057960;0.023977;quickSort
300800;74514977792;169728;5399316;5569044;5059860;0.023938;quickSort
300900;74575147792;169828;5401416;5571244;5061760;0.023913;quickSort
301000;74635337792;169928;5403516;5573444;5063660;0.023970;quickSort
301100;74695547792;170028;5405616;5575644;5065560;0.024355;quickSort
301200;74755777792;170128;5407716;5577844;5067460;0.023987;quickSort
301300;74816027792;170228;5409816;5580044;5069360;0.023976;quickSort
301400;74876297792;170328;5411916;5582244;5071260;0.023973;quickSort
301500;74936587792;170428;5414016;5584444;5073160;0.023987;quickSort
301600;74996897792;170528;5416116;5586644;5075060;0.023997;quickSort
301700;741057227792;170628;5418216;5588844;5076960;0.024008;quickSort
301800;741117577792;170728;5420316;5591044;5078860;0.025270;quickSort
301900;741177947792;170828;5422416;5593244;5080760;0.024042;quickSort
302000;75022585600;170928;5424516;5595444;5082660;0.024061;quickSort
302100;75082995600;171028;5426616;5597644;5084560;0.024000;quickSort
302200;75143425600;171128;5428716;5599844;5086460;0.024170;quickSort
302300;75203875600;171228;5430816;5602044;5088360;0.024083;quickSort
302400;75264345600;171328;5432916;5604244;5090260;0.024089;quickSort
302500;75324835600;171428;5435016;5606444;5092160;0.024105;quickSort
302600;75385345600;171528;5437116;5608644;5094060;0.024763;quickSort
302700;75445875600;171628;5439216;5610844;5095960;0.024161;quickSort
302800;75506425600;171728;5441316;5613044;5097860;0.024116;quickSort
302900;75566995600;171828;5443416;5615244;5099760;0.024195;quickSort
303000;75627585600;171928;5445516;5617444;5101660;0.024173;quickSort
303100;75688195600;172028;5447616;5619644;5103560;0.024166;quickSort
303200;75748825600;172128;5449716;5621844;5105460;0.024156;quickSort
303300;75809475600;172228;5451816;5624044;5107360;0.024190;quickSort
303400;75870145600;172328;5453916;5626244;5109260;0.025559;quickSort
303500;75930835600;172428;5456016;5628444;5111160;0.024277;quickSort
303600;75991545600;172528;5458116;5630644;5113060;0.024321;quickSort
303700;751052275600;172628;5460216;5632844;5114960;0.024231;quickSort
303800;751113025600;172728;5462316;5635044;5116860;0.024316;quickSort
303900;751173795600;172828;5464416;5637244;5118760;0.024341;quickSort
304000;76018833408;172928;5466516;5639444;5120660;0.024222;quickSort
304100;76079643408;173028;5468616;5641644;5122560;0.024568;quickSort
304200;76140473408;173128;5470716;5643844;5124460;0.024371;quickSort
304300;76201323408;173228;5472816;5646044;5126360;0.024306;quickSort
304400;76262193408;173328;5474916;5648244;5128260;0.024901;quickSort
304500;76323083408;173428;5477016;5650444;5130160;0.024748;quickSort
304600;76383993408;173528;5479116;5652644;5132060;0.024639;quickSort
304700;76444923408;173628;5481216;5654844;5133960;0.024320;quickSort
304800;76505873408;173728;5483316;5657044;5135860;0.024293;quickSort
304900;76566843408;173828;5485416;5659244;5137760;0.024370;quickSort
305000;76627833408;173928;5487516;5661444;5139660;0.024330;quickSort
305100;76688843408;174028;5489616;5663644;5141560;0.024348;quickSort
305200;76749873408;174128;5491716;5665844;5143460;0.024365;quickSort
305300;76810923408;174228;5493816;5668044;5145360;0.024343;quickSort
305400;76871993408;174328;5495916;5670244;5147260;0.025544;quickSort
305500;76933083408;174428;5498016;5672444;5149160;0.024428;quickSort
305600;76994193408;174528;5500116;5674644;5151060;0.024422;quickSort
305700;761055323408;174628;5502216;5676844;5152960;0.024435;quickSort
305800;761116473408;174728;5504316;5679044;5154860;0.024421;quickSort
305900;761177643408;174828;5506416;5681244;5156760;0.026453;quickSort
306000;77023081216;174928;5508516;5683444;5158660;0.024443;quickSort
306100;77084291216;175028;5510616;5685644;5160560;0.024515;quickSort
306200;77145521216;175128;5512716;5687844;5162460;0.025415;quickSort
306300;77206771216;175228;5514816;5690044;5164360;0.024491;quickSort
306400;77268041216;175328;5516916;5692244;5166260;0.024520;quickSort
306500;77329331216;175428;5519016;5694444;5168160;0.024529;quickSort
306600;77390641216;175528;5521116;5696644;5170060;0.024486;quickSort
306700;77451971216;175628;5523216;5698844;5171960;0.024519;quickSort
306800;77513321216;175728;5525316;5701044;5173860;0.024538;quickSort
306900;77574691216;175828;5527416;5703244;5175760;0.024525;quickSort
307000;77636081216;175928;5529516;5705444;5177660;0.024542;quickSort
307100;77697491216;176028;5531616;5707644;5179560;0.024569;quickSort
307200;77758921216;176128;5533716;5709844;5181460;0.024579;quickSort
307300;77820371216;176228;5535816;5712044;5183360;0.024577;quickSort
307400;77881841216;176328;5537916;5714244;5185260;0.025629;quickSort
307500;77943331216;176428;5540016;5716444;5187160;0.024617;quickSort
307600;771004841216;176528;5542116;5718644;5189060;0.024824;quickSort
307700;771066371216;176628;5544216;5720844;5190960;0.024945;quickSort
307800;771127921216;176728;5546316;5723044;5192860;0.025061;quickSort
307900;771189491216;176828;5548416;5725244;5194760;0.024619;quickSort
308000;78035329024;176928;5550516;5727444;5196660;0.024646;quickSort
308100;78096939024;177028;5552616;5729644;5198560;0.024693;quickSort
308200;78158569024;177128;5554716;5731844;5200460;0.024051;quickSort
308300;78220219024;177228;5556816;5734044;5202360;0.025118;quickSort
308400;78281889024;177328;5558916;5736244;5204260;0.026494;quickSort
308500;78343579024;177428;5561016;5738444;5206160;0.024077;quickSort
308600;78405289024;177528;5563116;5740644;5208060;0.024710;quickSort
308700;78467019024;177628;5565216;5742844;5209960;0.024636;quickSort
308800;78528769024;177728;5567316;5745044;5211860;0.024708;quickSort
308900;78590539024;177828;5569416;5747244;5213760;0.024750;quickSort
309000;78652329024;177928;5571516;5749444;5215660;0.024689;quickSort
309100;78714139024;178028;5573616;5751644;5217560;0.024776;quickSort
309200;78775969024;178128;5575716;5753844;5219460;0.024731;quickSort
309300;78837819024;178228;5577816;5756044;5221360;0.024751;quickSort
309400;78899689024;178328;5579916;5758244;5223260;0.024821;quickSort
309500;78961579024;178428;5582016;5760444;5225160;0.024810;quickSort
309600;781023489024;178528;5584116;5762644;5227060;0.024748;quickSort
309700;781085419024;178628;5586216;5764844;5228960;0.024923;quickSort
309800;781147369024;178728;5588316;5767044;5230860;0.024854;quickSort
309900;781209339024;178828;5590416;5769244;5232760;0.024841;quickSort
310100;79117586832;179028;5594616;5773644;5236560;0.024775;quickSort
310200;79179616832;179128;5596716;5775844;5238460;0.024896;quickSort
310300;79241666832;179228;5598816;5778044;5240360;0.024840;quickSort
310400;79303736832;179328;5600916;5780244;5242260;0.025101;quickSort
310500;79365826832;179428;5603016;5782444;5244160;0.024921;quickSort
310600;79427936832;179528;5605116;5784644;5246060;0.024869;quickSort
310700;79490066832;179628;5607216;5786844;5247960;0.024886;quickSort
310800;79552216832;179728;5609316;5789044;5249860;0.024938;quickSort
310900;79614386832;179828;5611416;5791244;5251760;0.024879;quickSort
311000;79676576832;179928;5613516;5793444;5253660;0.024628;quickSort
311100;79738786832;180028;5615616;5795644;5255560;0.024290;quickSort
311200;79801016832;180128;5617716;5797844;5257460;0.024468;quickSort
311300;79863266832;180228;5619816;5800044;5259360;0.024967;quickSort
311400;79925536832;180328;5621916;5802244;5261260;0.024959;quickSort
311500;79987826832;180428;5624016;5804444;5263160;0.025000;quickSort
311600;791050136832;180528;5626116;5806644;5265060;0.024965;quickSort
311700;791112466832;180628;5628216;5808844;5266960;0.024973;quickSort
311800;791174816832;180728;5630316;5811044;5268860;0.024986;quickSort
311900;80021434640;180828;5632416;5813244;5270760;0.024934;quickSort
312000;80083824640;180928;5634516;5815444;5272660;0.025058;quickSort
312100;80146234640;181028;5636616;5817644;5274560;0.025006;quickSort
312200;80208664640;181128;5638716;5819844;5276460;0.024996;quickSort
312300;80271114640;181228;5640816;5822044;5278360;0.025095;quickSort
312400;80333584640;181328;5642916;5824244;5280260;0.025648;quickSort
312500;80396074640;181428;5645016;5826444;5282160;0.025398;quickSort
312600;80458584640;181528;5647116;5828644;5284060;0.025056;quickSort
312700;80521114640;181628;5649216;5830844;5285960;0.025105;quickSort
312800;80583664640;181728;5651316;5833044;5287860;0.025090;quickSort
312900;80646234640;181828;5653416;5835244;5289760;0.025111;quickSort
313000;80708824640;181928;5655516;5837444;5291660;0.025089;quickSort
313100;80771434640;182028;5657616;5839644;5293560;0.025197;quickSort
313200;80834064640;182128;5659716;5841844;5295460;0.025157;quickSort
313300;80896714640;182228;5661816;5844044;5297360;0.025138;quickSort
313400;80959384640;182328;5663916;5846244;5299260;0.025275;quickSort
313500;801022074640;182428;5666016;5848444;5301160;0.025268;quickSort
313600;801084784640;182528;5668116;5850644;5303060;0.025171;quickSort
313700;801147514640;182628;5670216;5852844;5304960;0.025488;quickSort
313800;801210264640;182728;5672316;5855044;5306860;0.025204;quickSort
313900;81057282448;182828;5674416;5857244;5308760;0.025333;quickSort
314000;81120072448;182928;5676516;5859444;5310660;0.025164;quickSort
314100;81182882448;183028;5678616;5861644;5312560;0.025252;quickSort
314200;81245712448;183128;5680716;5863844;5314460;0.025230;quickSort
314300;81308562448;183228;5682816;5866044;5316360;0.025270;quickSort
314400;81371432448;183328;5684916;5868244;5318260;0.025298;quickSort
314500;81434322448;183428;5687016;5870444;5320160;0.025266;quickSort
314600;81497232448;183528;5689116;5872644;5322060;0.025305;quickSort
314700;81560162448;183628;5691216;5874844;5323960;0.025370;quickSort
314800;81623112448;183728;5693316;5877044;5325860;0.025389;quickSort
314900;81686082448;183828;5695416;5879244;5327760;0.025282;quickSort
315000;81749072448;183928;5697516;5881444;5329660;0.027759;quickSort
315100;81812082448;184028;5699616;5883644;5331560;0.025443;quickSort
315200;81875112448;184128;5701716;5885844;5333460;0.025312;quickSort
315300;81938162448;184228;5703816;5888044;5335360;0.025310;quickSort
315400;811001232448;184328;5705916;5890244;5337260;0.025651;quickSort
315500;811064322448;184428;5708016;5892444;5339160;0.025419;quickSort
315600;811127432448;184528;5710116;5894644;5341060;0.025572;quickSort
315700;811190562448;184628;5712216;5896844;5342960;0.025488;quickSort
315800;82037960256;184728;5714316;5899044;5344860;0.025584;quickSort
315900;82101130256;184828;5716416;5901244;5346760;0.025704;quickSort
316000;82164320256;184928;5718516;5903444;5348660;0.025537;quickSort
316100;82227530256;185028;5720616;5905644;5350560;0.025569;quickSort
316200;82290760256;185128;5722716;5907844;5352460;0.025529;quickSort
316300;82354010256;185228;5724816;5910044;5354360;0.025464;quickSort
316400;82417280256;185328;5726916;5912244;5356260;0.025936;quickSort
316500;82480570256;185428;5729016;5914444;5358160;0.026059;quickSort
316600;82543880256;185528;5731116;5916644;5360060;0.025489;quickSort
316700;82607210256;185628;5733216;5918844;5361960;0.025540;quickSort
316800;82670560256;185728;5735316;5921044;5363860;0.025578;quickSort
316900;82733930256;185828;5737416;5923244;5365760;0.025581;quickSort
317000;82797320256;185928;5739516;5925444;5367660;0.025812;quickSort
317100;82860730256;186028;5741616;5927644;5369560;0.025861;quickSort
317200;82924160256;186128;5743716;5929844;5371460;0.025675;quickSort
317300;82987610256;186228;5745816;5932044;5373360;0.025672;quickSort
317400;821051080256;186328;5747916;5934244;5375260;0.025622;quickSort
317500;821114570256;186428;5750016;5936444;5377160;0.025599;quickSort
317600;821178080256;186528;5752116;5938644;5379060;0.025737;quickSort
317700;83025858064;186628;5754216;5940844;5380960;0.025739;quickSort
317800;83089408064;186728;5756316;5943044;5382860;0.025856;quickSort
317900;83152978064;186828;5758416;5945244;5384760;0.025791;quickSort
318000;83216568064;186928;5760516;5947444;5386660;0.025837;quickSort
318100;83280178064;187028;5762616;5949644;5388560;0.025873;quickSort
318200;83343808064;187128;5764716;5951844;5390460;0.025761;quickSort
318300;83407458064;187228;5766816;5954044;5392360;0.026087;quickSort
318400;83471128064;187328;5768916;5956244;5394260;0.025782;quickSort
318500;83534818064;187428;5771016;5958444;5396160;0.025720;quickSort
318600;83598528064;187528;5773116;5960644;5398060;0.025733;quickSort
318700;83662258064;187628;5775216;5962844;5399960;0.025756;quickSort
318800;83726008064;187728;5777316;5965044;5401860;0.025754;quickSort
318900;83789778064;187828;5779416;5967244;5403760;0.027732;quickSort
319000;83853568064;187928;5781516;5969444;5405660;0.025794;quickSort
319100;83917378064;188028;5783616;5971644;5407560;0.025802;quickSort
319200;83981208064;188128;5785716;5973844;5409460;0.025792;quickSort
319300;831045058064;188228;5787816;5976044;5411360;0.025775;quickSort
319400;831108928064;188328;5789916;5978244;5413260;0.025775;quickSort
319500;831172818064;188428;5792016;5980444;5415160;0.025820;quickSort
319600;84020975872;188528;5794116;5982644;5417060;0.025843;quickSort
319700;84084905872;188628;5796216;5984844;5418960;0.025849;quickSort
319800;84148855872;188728;5798316;5987044;5420860;0.025839;quickSort
319900;84212825872;188828;5800416;5989244;5422760;0.025832;quickSort
320000;84276815872;188928;5802516;5991444;5424660;0.025883;quickSort
320100;84340825872;189028;5804616;5993644;5426560;0.025848;quickSort
320200;84404855872;189128;5806716;5995844;5428460;0.025858;quickSort
320300;84468905872;189228;5808816;5998044;5430360;0.025917;quickSort
320400;84532975872;189328;5810916;6000244;5432260;0.026060;quickSort
320500;84597065872;189428;5813016;6002444;5434160;0.025930;quickSort
320600;84661175872;189528;5815116;6004644;5436060;0.029039;quickSort
320700;84725305872;189628;5817216;6006844;5437960;0.025887;quickSort
320800;84789455872;189728;5819316;6009044;5439860;0.025941;quickSort
320900;84853625872;189828;5821416;6011244;5441760;0.025927;quickSort
321000;84917815872;189928;5823516;6013444;5443660;0.026001;quickSort
321100;84982025872;190028;5825616;6015644;5445560;0.025997;quickSort
321200;841046255872;190128;5827716;6017844;5447460;0.025938;quickSort
321300;841110505872;190228;5829816;6020044;5449360;0.026045;quickSort
321400;841174775872;190328;5831916;6022244;5451260;0.026008;quickSort
321500;85023313680;190428;5834016;6024444;5453160;0.025982;quickSort
321600;85087623680;190528;5836116;6026644;5455060;0.026018;quickSort
321700;85151953680;190628;5838216;6028844;5456960;0.026019;quickSort
321800;85216303680;190728;5840316;6031044;5458860;0.026227;quickSort
321900;85280673680;190828;5842416;6033244;5460760;0.026219;quickSort
322000;85345063680;190928;5844516;6035444;5462660;0.026105;quickSort
322100;85409473680;191028;5846616;6037644;5464560;0.026449;quickSort
322200;85473903680;191128;5848716;6039844;5466460;0.026087;quickSort
322300;85538353680;191228;5850816;6042044;5468360;0.026147;quickSort
322400;85602823680;191328;5852916;6044244;5470260;0.028009;quickSort
322500;85667313680;191428;5855016;6046444;5472160;0.026186;quickSort
322600;85731823680;191528;5857116;6048644;5474060;0.026285;quickSort
322700;85796353680;191628;5859216;6050844;5475960;0.026029;quickSort
322800;85860903680;191728;5861316;6053044;5477860;0.026136;quickSort
322900;85925473680;191828;5863416;6055244;5479760;0.026158;quickSort
323000;85990063680;191928;5865516;6057444;5481660;0.026148;quickSort
323100;851054673680;192028;5867616;6059644;5483560;0.026149;quickSort
323200;851119303680;192128;5869716;6061844;5485460;0.026157;quickSort
323300;851183953680;192228;5871816;6064044;5487360;0.026170;quickSort
323400;86032871488;192328;5873916;6066244;5489260;0.026184;quickSort
323500;86097561488;192428;5876016;6068444;5491160;0.026322;quickSort
323600;86162271488;192528;5878116;6070644;5493060;0.027349;quickSort
323700;86227001488;192628;5880216;6072844;5494960;0.026225;quickSort
323800;86291751488;192728;5882316;6075044;5496860;0.026220;quickSort
323900;86356521488;192828;5884416;6077244;5498760;0.026239;quickSort
324000;86421311488;192928;5886516;6079444;5500660;0.026225;quickSort
324100;86486121488;193028;5888616;6081644;5502560;0.026630;quickSort
324200;86550951488;193128;5890716;6083844;5504460;0.026696;quickSort
324300;86615801488;193228;5892816;6086044;5506360;0.026308;quickSort
324400;86680671488;193328;5894916;6088244;5508260;0.026297;quickSort
324500;86745561488;193428;5897016;6090444;5510160;0.026992;quickSort
324600;86810471488;193528;5899116;6092644;5512060;0.026291;quickSort
324700;86875401488;193628;5901216;6094844;5513960;0.026297;quickSort
324800;86940351488;193728;5903316;6097044;5515860;0.026339;quickSort
324900;861005321488;193828;5905416;6099244;5517760;0.026360;quickSort
325000;861070311488;193928;5907516;6101444;5519660;0.026587;quickSort
325100;861135321488;194028;5909616;6103644;5521560;0.026346;quickSort
325200;861200351488;194128;5911716;6105844;5523460;0.026356;quickSort
325300;87049649296;194228;5913816;6108044;5525360;0.026296;quickSort
325400;87114719296;194328;5915916;6110244;5527260;0.026473;quickSort
325500;87179809296;194428;5918016;6112444;5529160;0.026592;quickSort
325600;87244919296;194528;5920116;6114644;5531060;0.026406;quickSort
325700;87310049296;194628;5922216;6116844;5532960;0.026436;quickSort
325800;87375199296;194728;5924316;6119044;5534860;0.026427;quickSort
325900;87440369296;194828;5926416;6121244;5536760;0.026443;quickSort
326000;87505559296;194928;5928516;6123444;5538660;0.026414;quickSort
326100;87570769296;195028;5930616;6125644;5540560;0.026437;quickSort
326200;87635999296;195128;5932716;6127844;5542460;0.026450;quickSort
326300;87701249296;195228;5934816;6130044;5544360;0.026485;quickSort
326400;87766519296;195328;5936916;6132244;5546260;0.026535;quickSort
326500;87831809296;195428;5939016;6134444;5548160;0.025828;quickSort
326600;87897119296;195528;5941116;6136644;5550060;0.026644;quickSort
326700;87962449296;195628;5943216;6138844;5551960;0.026625;quickSort
326800;871027799296;195728;5945316;6141044;5553860;0.026535;quickSort
326900;871093169296;195828;5947416;6143244;5555760;0.026522;quickSort
327000;871158559296;195928;5949516;6145444;5557660;0.026643;quickSort
327100;88008217104;196028;5951616;6147644;5559560;0.026725;quickSort
327200;88073647104;196128;5953716;6149844;5561460;0.026697;quickSort
327300;88139097104;196228;5955816;6152044;5563360;0.026847;quickSort
327400;88204567104;196328;5957916;6154244;5565260;0.026584;quickSort
327500;88270057104;196428;5960016;6156444;5567160;0.026548;quickSort
327600;88335567104;196528;5962116;6158644;5569060;0.026556;quickSort
327700;88401097104;196628;5964216;6160844;5570960;0.026624;quickSort
327800;88466647104;196728;5966316;6163044;5572860;0.026556;quickSort
327900;88532217104;196828;5968416;6165244;5574760;0.026550;quickSort
328000;88597807104;196928;5970516;6167444;5576660;0.026601;quickSort
328100;88663417104;197028;5972616;6169644;5578560;0.026967;quickSort
328200;88729047104;197128;5974716;6171844;5580460;0.026630;quickSort
328300;88794697104;197228;5976816;6174044;5582360;0.026649;quickSort
328400;88860367104;197328;5978916;6176244;5584260;0.026655;quickSort
328500;88926057104;197428;5981016;6178444;5586160;0.026694;quickSort
328600;88991767104;197528;5983116;6180644;5588060;0.026681;quickSort
328700;881057497104;197628;5985216;6182844;5589960;0.026732;quickSort
328800;881123247104;197728;5987316;6185044;5591860;0.026701;quickSort
328900;881189017104;197828;5989416;6187244;5593760;0.026702;quickSort
329000;89039054912;197928;5991516;6189444;5595660;0.026714;quickSort
329100;89104864912;198028;5993616;6191644;5597560;0.026745;quickSort
329200;89170694912;198128;5995716;6193844;5599460;0.027166;quickSort
329300;89236544912;198228;5997816;6196044;5601360;0.027034;quickSort
329400;89302414912;198328;5999916;6198244;5603260;0.026936;quickSort
329500;89368304912;198428;6002016;6200444;5605160;0.026949;quickSort
329600;89434214912;198528;6004116;6202644;5607060;0.027052;quickSort
329700;89500144912;198628;6006216;6204844;5608960;0.026793;quickSort
329800;89566094912;198728;6008316;6207044;5610860;0.026910;quickSort
329900;89632064912;198828;6010416;6209244;5612760;0.026942;quickSort
330000;89698054912;198928;6012516;6211444;5614660;0.026168;quickSort
330100;89764064912;199028;6014616;6213644;5616560;0.026198;quickSort
330200;89830094912;199128;6016716;6215844;5618460;0.026886;quickSort
330300;89896144912;199228;6018816;6218044;5620360;0.026862;quickSort
330400;89962214912;199328;6020916;6220244;5622260;0.026935;quickSort
330500;891028304912;199428;6023016;6222444;5624160;0.026877;quickSort
330600;891094414912;199528;6025116;6224644;5626060;0.026987;quickSort
330700;891160544912;199628;6027216;6226844;5627960;0.026961;quickSort
330800;90010942720;199728;6029316;6229044;5629860;0.026919;quickSort
330900;90077112720;199828;6031416;6231244;5631760;0.026918;quickSort
331000;90143302720;199928;6033516;6233444;5633660;0.027012;quickSort
331100;90209512720;200028;6035616;6235644;5635560;0.028145;quickSort
331200;90275742720;200128;6037716;6237844;5637460;0.026989;quickSort
331300;90341992720;200228;6039816;6240044;5639360;0.026987;quickSort
331400;90408262720;200328;6041916;6242244;5641260;0.027095;quickSort
331500;90474552720;200428;6044016;6244444;5643160;0.027020;quickSort
331600;90540862720;200528;6046116;6246644;5645060;0.027026;quickSort
331700;90607192720;200628;6048216;6248844;5646960;0.026983;quickSort
331800;90673542720;200728;6050316;6251044;5648860;0.027089;quickSort
331900;90739912720;200828;6052416;6253244;5650760;0.027798;quickSort
332000;90806302720;200928;6054516;6255444;5652660;0.026654;quickSort
332100;90872712720;201028;6056616;6257644;5654560;0.027027;quickSort
332200;90939142720;201128;6058716;6259844;5656460;0.027153;quickSort
332300;901005592720;201228;6060816;6262044;5658360;0.027153;quickSort
332400;901072062720;201328;6062916;6264244;5660260;0.027903;quickSort
332500;901138552720;201428;6065016;6266444;5662160;0.027054;quickSort
332600;901205062720;201528;6067116;6268644;5664060;0.027117;quickSort
332700;91055840528;201628;6069216;6270844;5665960;0.027212;quickSort
332800;91122390528;201728;6071316;6273044;5667860;0.027190;quickSort
332900;91188960528;201828;6073416;6275244;5669760;0.027208;quickSort
333000;91255550528;201928;6075516;6277444;5671660;0.027244;quickSort
333100;91322160528;202028;6077616;6279644;5673560;0.027206;quickSort
333200;91388790528;202128;6079716;6281844;5675460;0.027177;quickSort
333300;91455440528;202228;6081816;6284044;5677360;0.027288;quickSort
333400;91522110528;202328;6083916;6286244;5679260;0.027302;quickSort
333500;91588800528;202428;6086016;6288444;5681160;0.027331;quickSort
333600;91655510528;202528;6088116;6290644;5683060;0.027276;quickSort
333700;91722240528;202628;6090216;6292844;5684960;0.027296;quickSort
333800;91788990528;202728;6092316;6295044;5686860;0.027361;quickSort
333900;91855760528;202828;6094416;6297244;5688760;0.027325;quickSort
334000;91922550528;202928;6096516;6299444;5690660;0.027300;quickSort
334100;91989360528;203028;6098616;6301644;5692560;0.027464;quickSort
334300;911123040528;203228;6102816;6306044;5696360;0.027288;quickSort
334400;911189910528;203328;6104916;6308244;5698260;0.027606;quickSort
334500;92041048336;203428;6107016;6310444;5700160;0.027616;quickSort
334600;92107958336;203528;6109116;6312644;5702060;0.027382;quickSort
334700;92174888336;203628;6111216;6314844;5703960;0.027424;quickSort
334800;92241838336;203728;6113316;6317044;5705860;0.027430;quickSort
334900;92308808336;203828;6115416;6319244;5707760;0.027432;quickSort
335000;92375798336;203928;6117516;6321444;5709660;0.027423;quickSort
335100;92442808336;204028;6119616;6323644;5711560;0.027474;quickSort
335200;92509838336;204128;6121716;6325844;5713460;0.027436;quickSort
335300;92576888336;204228;6123816;6328044;5715360;0.027455;quickSort
335400;92643958336;204328;6125916;6330244;5717260;0.027493;quickSort
335500;92711048336;204428;6128016;6332444;5719160;0.027469;quickSort
335600;92778158336;204528;6130116;6334644;5721060;0.028275;quickSort
335700;92845288336;204628;6132216;6336844;5722960;0.027409;quickSort
335800;92912438336;204728;6134316;6339044;5724860;0.027480;quickSort
335900;92979608336;204828;6136416;6341244;5726760;0.027908;quickSort
336000;921046798336;204928;6138516;6343444;5728660;0.027619;quickSort
336100;921114008336;205028;6140616;6345644;5730560;0.027937;quickSort
336200;921181238336;205128;6142716;6347844;5732460;0.028242;quickSort
336300;93032736144;205228;6144816;6350044;5734360;0.027582;quickSort
336400;93100006144;205328;6146916;6352244;5736260;0.027629;quickSort
336500;93167296144;205428;6149016;6354444;5738160;0.027568;quickSort
336600;93234606144;205528;6151116;6356644;5740060;0.027631;quickSort
336700;93301936144;205628;6153216;6358844;5741960;0.027673;quickSort
336800;93369286144;205728;6155316;6361044;5743860;0.028934;quickSort
336900;93436656144;205828;6157416;6363244;5745760;0.027664;quickSort
337000;93504046144;205928;6159516;6365444;5747660;0.027686;quickSort
337100;93571456144;206028;6161616;6367644;5749560;0.027697;quickSort
337200;93638886144;206128;6163716;6369844;5751460;0.027704;quickSort
337300;93706336144;206228;6165816;6372044;5753360;0.027708;quickSort
337400;93773806144;206328;6167916;6374244;5755260;0.027726;quickSort
337500;93841296144;206428;6170016;6376444;5757160;0.027736;quickSort
337600;93908806144;206528;6172116;6378644;5759060;0.027744;quickSort
337700;93976336144;206628;6174216;6380844;5760960;0.027759;quickSort
337800;931043886144;206728;6176316;6383044;5762860;0.027769;quickSort
337900;931111456144;206828;6178416;6385244;5764760;0.029245;quickSort
338000;931179046144;206928;6180516;6387444;5766660;0.027765;quickSort
338100;94030903952;207028;6182616;6389644;5768560;0.028033;quickSort
338200;94098533952;207128;6184716;6391844;5770460;0.027821;quickSort
338300;94166183952;207228;6186816;6394044;5772360;0.027862;quickSort
338400;94233853952;207328;6188916;6396244;5774260;0.027835;quickSort
338500;94301543952;207428;6191016;6398444;5776160;0.027883;quickSort
338600;94369253952;207528;6193116;6400644;5778060;0.027861;quickSort
338700;94436983952;207628;6195216;6402844;5779960;0.027891;quickSort
338800;94504733952;207728;6197316;6405044;5781860;0.027879;quickSort
338900;94572503952;207828;6199416;6407244;5783760;0.027959;quickSort
339000;94640293952;207928;6201516;6409444;5785660;0.027891;quickSort
339100;94708103952;208028;6203616;6411644;5787560;0.027888;quickSort
339200;94775933952;208128;6205716;6413844;5789460;0.028809;quickSort
339300;94843783952;208228;6207816;6416044;5791360;0.028142;quickSort
339400;94911653952;208328;6209916;6418244;5793260;0.028017;quickSort
339500;94979543952;208428;6212016;6420444;5795160;0.027959;quickSort
339600;941047453952;208528;6214116;6422644;5797060;0.028498;quickSort
339700;941115383952;208628;6216216;6424844;5798960;0.028114;quickSort
339800;941183333952;208728;6218316;6427044;5800860;0.028007;quickSort
339900;95035551760;208828;6220416;6429244;5802760;0.028034;quickSort
340000;95103541760;208928;6222516;6431444;5804660;0.028011;quickSort
340100;95171551760;209028;6224616;6433644;5806560;0.028066;quickSort
340200;95239581760;209128;6226716;6435844;5808460;0.028074;quickSort
340300;95307631760;209228;6228816;6438044;5810360;0.028073;quickSort
340400;95375701760;209328;6230916;6440244;5812260;0.028726;quickSort
340500;95443791760;209428;6233016;6442444;5814160;0.028173;quickSort
340600;95511901760;209528;6235116;6444644;5816060;0.028036;quickSort
340700;95580031760;209628;6237216;6446844;5817960;0.028107;quickSort
340800;95648181760;209728;6239316;6449044;5819860;0.028106;quickSort
340900;95716351760;209828;6241416;6451244;5821760;0.028083;quickSort
341000;95784541760;209928;6243516;6453444;5823660;0.028090;quickSort
341100;95852751760;210028;6245616;6455644;5825560;0.028137;quickSort
341200;95920981760;210128;6247716;6457844;5827460;0.028118;quickSort
341300;95989231760;210228;6249816;6460044;5829360;0.028138;quickSort
341400;951057501760;210328;6251916;6462244;5831260;0.028230;quickSort
341500;951125791760;210428;6254016;6464444;5833160;0.028192;quickSort
341600;951194101760;210528;6256116;6466644;5835060;0.028187;quickSort
341700;96046679568;210628;6258216;6468844;5836960;0.028542;quickSort
341800;96115029568;210728;6260316;6471044;5838860;0.027822;quickSort
341900;96183399568;210828;6262416;6473244;5840760;0.027474;quickSort
342000;96251789568;210928;6264516;6475444;5842660;0.028108;quickSort
342100;96320199568;211028;6266616;6477644;5844560;0.028217;quickSort
342200;96388629568;211128;6268716;6479844;5846460;0.028289;quickSort
342300;96457079568;211228;6270816;6482044;5848360;0.028261;quickSort
342400;96525549568;211328;6272916;6484244;5850260;0.028275;quickSort
342500;96594039568;211428;6275016;6486444;5852160;0.028251;quickSort
342600;96662549568;211528;6277116;6488644;5854060;0.029294;quickSort
342700;96731079568;211628;6279216;6490844;5855960;0.028563;quickSort
342800;96799629568;211728;6281316;6493044;5857860;0.028695;quickSort
342900;96868199568;211828;6283416;6495244;5859760;0.029081;quickSort
343000;96936789568;211928;6285516;6497444;5861660;0.029756;quickSort
343100;961005399568;212028;6287616;6499644;5863560;0.028914;quickSort
343200;961074029568;212128;6289716;6501844;5865460;0.028405;quickSort
343300;961142679568;212228;6291816;6504044;5867360;0.028547;quickSort
343400;961211349568;212328;6293916;6506244;5869260;0.028434;quickSort
343500;97064287376;212428;6296016;6508444;5871160;0.028400;quickSort
343600;97132997376;212528;6298116;6510644;5873060;0.028384;quickSort
343700;97201727376;212628;6300216;6512844;5874960;0.028421;quickSort
343800;97270477376;212728;6302316;6515044;5876860;0.028454;quickSort
343900;97339247376;212828;6304416;6517244;5878760;0.028515;quickSort
344000;97408037376;212928;6306516;6519444;5880660;0.028459;quickSort
344100;97476847376;213028;6308616;6521644;5882560;0.028453;quickSort
344200;97545677376;213128;6310716;6523844;5884460;0.028461;quickSort
344300;97614527376;213228;6312816;6526044;5886360;0.028472;quickSort
344400;97683397376;213328;6314916;6528244;5888260;0.029196;quickSort
344500;97752287376;213428;6317016;6530444;5890160;0.028477;quickSort
344600;97821197376;213528;6319116;6532644;5892060;0.028495;quickSort
344700;97890127376;213628;6321216;6534844;5893960;0.028039;quickSort
344800;97959077376;213728;6323316;6537044;5895860;0.027836;quickSort
344900;971028047376;213828;6325416;6539244;5897760;0.028527;quickSort
345000;971097037376;213928;6327516;6541444;5899660;0.028618;quickSort
345100;971166047376;214028;6329616;6543644;5901560;0.028598;quickSort
345200;98019325184;214128;6331716;6545844;5903460;0.028945;quickSort
345300;98088375184;214228;6333816;6548044;5905360;0.029174;quickSort
345400;98157445184;214328;6335916;6550244;5907260;0.029256;quickSort
345500;98226535184;214428;6338016;6552444;5909160;0.029375;quickSort
345600;98295645184;214528;6340116;6554644;5911060;0.028970;quickSort
345700;98364775184;214628;6342216;6556844;5912960;0.029164;quickSort
345800;98433925184;214728;6344316;6559044;5914860;0.028273;quickSort
345900;98503095184;214828;6346416;6561244;5916760;0.027962;quickSort
346000;98572285184;214928;6348516;6563444;5918660;0.028646;quickSort
346100;98641495184;215028;6350616;6565644;5920560;0.028629;quickSort
346200;98710725184;215128;6352716;6567844;5922460;0.028716;quickSort
346300;98779975184;215228;6354816;6570044;5924360;0.028875;quickSort
346400;98849245184;215328;6356916;6572244;5926260;0.028757;quickSort
346500;98918535184;215428;6359016;6574444;5928160;0.028634;quickSort
346600;98987845184;215528;6361116;6576644;5930060;0.028969;quickSort
346700;981057175184;215628;6363216;6578844;5931960;0.029185;quickSort
346800;981126525184;215728;6365316;6581044;5933860;0.029014;quickSort
346900;981195895184;215828;6367416;6583244;5935760;0.028742;quickSort
347000;99049532992;215928;6369516;6585444;5937660;0.028700;quickSort
347100;99118942992;216028;6371616;6587644;5939560;0.028767;quickSort
347200;99188372992;216128;6373716;6589844;5941460;0.028803;quickSort
347300;99257822992;216228;6375816;6592044;5943360;0.028770;quickSort
347400;99327292992;216328;6377916;6594244;5945260;0.028778;quickSort
347500;99396782992;216428;6380016;6596444;5947160;0.028744;quickSort
347600;99466292992;216528;6382116;6598644;5949060;0.028799;quickSort
347700;99535822992;216628;6384216;6600844;5950960;0.028743;quickSort
347800;99605372992;216728;6386316;6603044;5952860;0.028876;quickSort
347900;99674942992;216828;6388416;6605244;5954760;0.028828;quickSort
348000;99744532992;216928;6390516;6607444;5956660;0.030181;quickSort
348100;99814142992;217028;6392616;6609644;5958560;0.028852;quickSort
348200;99883772992;217128;6394716;6611844;5960460;0.028839;quickSort
348300;99953422992;217228;6396816;6614044;5962360;0.029064;quickSort
348400;991023092992;217328;6398916;6616244;5964260;0.029288;quickSort
348500;991092782992;217428;6401016;6618444;5966160;0.028921;quickSort
348600;991162492992;217528;6403116;6620644;5968060;0.028873;quickSort
348700;100016470800;217628;6405216;6622844;5969960;0.028944;quickSort
348800;100086220800;217728;6407316;6625044;5971860;0.028891;quickSort
348900;100155990800;217828;6409416;6627244;5973760;0.028382;quickSort
349000;100225780800;217928;6411516;6629444;5975660;0.028926;quickSort
349100;100295590800;218028;6413616;6631644;5977560;0.029388;quickSort
349200;100365420800;218128;6415716;6633844;5979460;0.029225;quickSort
349300;100435270800;218228;6417816;6636044;5981360;0.029109;quickSort
349400;100505140800;218328;6419916;6638244;5983260;0.028941;quickSort
349500;100575030800;218428;6422016;6640444;5985160;0.028960;quickSort
349600;100644940800;218528;6424116;6642644;5987060;0.029031;quickSort
349700;100714870800;218628;6426216;6644844;5988960;0.028992;quickSort
349800;100784820800;218728;6428316;6647044;5990860;0.029148;quickSort
349900;100854790800;218828;6430416;6649244;5992760;0.029013;quickSort
350000;100924780800;218928;6432516;6651444;5994660;0.029041;quickSort
350100;100994790800;219028;6434616;6653644;5996560;0.029533;quickSort
350200;1001064820800;219128;6436716;6655844;5998460;0.029135;quickSort
350300;1001134870800;219228;6438816;6658044;6000360;0.029073;quickSort
350400;1001204940800;219328;6440916;6660244;6002260;0.028387;quickSort
350500;101059278608;219428;6443016;6662444;6004160;0.028598;quickSort
350600;101129388608;219528;6445116;6664644;6006060;0.029139;quickSort
350700;101199518608;219628;6447216;6666844;6007960;0.029151;quickSort
350800;101269668608;219728;6449316;6669044;6009860;0.029136;quickSort
350900;101339838608;219828;6451416;6671244;6011760;0.029167;quickSort
351000;101410028608;219928;6453516;6673444;6013660;0.029170;quickSort
351100;101480238608;220028;6455616;6675644;6015560;0.029193;quickSort
351200;101550468608;220128;6457716;6677844;6017460;0.029587;quickSort
351300;101620718608;220228;6459816;6680044;6019360;0.029267;quickSort
351400;101690988608;220328;6461916;6682244;6021260;0.029301;quickSort
351500;101761278608;220428;6464016;6684444;6023160;0.029395;quickSort
351700;101901918608;220628;6468216;6688844;6026960;0.029311;quickSort
351800;101972268608;220728;6470316;6691044;6028860;0.029468;quickSort
351900;1011042638608;220828;6472416;6693244;6030760;0.029519;quickSort
352000;1011113028608;220928;6474516;6695444;6032660;0.029393;quickSort
352100;1011183438608;221028;6476616;6697644;6034560;0.029268;quickSort
352200;102038116416;221128;6478716;6699844;6036460;0.031047;quickSort
352300;102108566416;221228;6480816;6702044;6038360;0.031812;quickSort
352400;102179036416;221328;6482916;6704244;6040260;0.030288;quickSort
352500;102249526416;221428;6485016;6706444;6042160;0.030649;quickSort
352600;102320036416;221528;6487116;6708644;6044060;0.029514;quickSort
352700;102390566416;221628;6489216;6710844;6045960;0.029619;quickSort
352800;102461116416;221728;6491316;6713044;6047860;0.029295;quickSort
352900;102531686416;221828;6493416;6715244;6049760;0.029336;quickSort
353000;102602276416;221928;6495516;6717444;6051660;0.029310;quickSort
353100;102672886416;222028;6497616;6719644;6053560;0.029371;quickSort
353200;102743516416;222128;6499716;6721844;6055460;0.029399;quickSort
353300;102814166416;222228;6501816;6724044;6057360;0.029306;quickSort
353400;102884836416;222328;6503916;6726244;6059260;0.029411;quickSort
353500;102955526416;222428;6506016;6728444;6061160;0.029334;quickSort
353600;1021026236416;222528;6508116;6730644;6063060;0.030593;quickSort
353700;1021096966416;222628;6510216;6732844;6064960;0.029736;quickSort
353800;1021167716416;222728;6512316;6735044;6066860;0.029517;quickSort
353900;103022734224;222828;6514416;6737244;6068760;0.029440;quickSort
354000;103093524224;222928;6516516;6739444;6070660;0.029367;quickSort
354100;103164334224;223028;6518616;6741644;6072560;0.029483;quickSort
354200;103235164224;223128;6520716;6743844;6074460;0.029450;quickSort
354300;103306014224;223228;6522816;6746044;6076360;0.030581;quickSort
354400;103376884224;223328;6524916;6748244;6078260;0.029807;quickSort
354500;103447774224;223428;6527016;6750444;6080160;0.029580;quickSort
354600;103518684224;223528;6529116;6752644;6082060;0.030990;quickSort
354700;103589614224;223628;6531216;6754844;6083960;0.029526;quickSort
354800;103660564224;223728;6533316;6757044;6085860;0.029504;quickSort
354900;103731534224;223828;6535416;6759244;6087760;0.029483;quickSort
355000;103802524224;223928;6537516;6761444;6089660;0.029506;quickSort
355100;103873534224;224028;6539616;6763644;6091560;0.029492;quickSort
355200;103944564224;224128;6541716;6765844;6093460;0.029501;quickSort
355300;1031015614224;224228;6543816;6768044;6095360;0.029507;quickSort
355400;1031086684224;224328;6545916;6770244;6097260;0.029538;quickSort
355500;1031157774224;224428;6548016;6772444;6099160;0.029529;quickSort
355600;104013132032;224528;6550116;6774644;6101060;0.029592;quickSort
355700;104084262032;224628;6552216;6776844;6102960;0.029568;quickSort
355800;104155412032;224728;6554316;6779044;6104860;0.029557;quickSort
355900;104226582032;224828;6556416;6781244;6106760;0.030933;quickSort
356000;104297772032;224928;6558516;6783444;6108660;0.029583;quickSort
356100;104368982032;225028;6560616;6785644;6110560;0.029604;quickSort
356200;104440212032;225128;6562716;6787844;6112460;0.029653;quickSort
356300;104511462032;225228;6564816;6790044;6114360;0.029604;quickSort
356500;104654022032;225428;6569016;6794444;6118160;0.029588;quickSort
356600;104725332032;225528;6571116;6796644;6120060;0.029596;quickSort
356700;104796662032;225628;6573216;6798844;6121960;0.029645;quickSort
356800;104868012032;225728;6575316;6801044;6123860;0.029622;quickSort
356900;104939382032;225828;6577416;6803244;6125760;0.029680;quickSort
357000;1041010772032;225928;6579516;6805444;6127660;0.029659;quickSort
357100;1041082182032;226028;6581616;6807644;6129560;0.029649;quickSort
357200;1041153612032;226128;6583716;6809844;6131460;0.029701;quickSort
357300;105009309840;226228;6585816;6812044;6133360;0.029668;quickSort
357400;105080779840;226328;6587916;6814244;6135260;0.029658;quickSort
357500;105152269840;226428;6590016;6816444;6137160;0.029674;quickSort
357600;105223779840;226528;6592116;6818644;6139060;0.030159;quickSort
357700;105295309840;226628;6594216;6820844;6140960;0.030730;quickSort
357800;105366859840;226728;6596316;6823044;6142860;0.029670;quickSort
357900;105438429840;226828;6598416;6825244;6144760;0.029749;quickSort
358000;105510019840;226928;6600516;6827444;6146660;0.029701;quickSort
358100;105581629840;227028;6602616;6829644;6148560;0.029782;quickSort
358200;105653259840;227128;6604716;6831844;6150460;0.029770;quickSort
358300;105724909840;227228;6606816;6834044;6152360;0.029763;quickSort
358400;105796579840;227328;6608916;6836244;6154260;0.029762;quickSort
358500;105868269840;227428;6611016;6838444;6156160;0.030212;quickSort
358600;105939979840;227528;6613116;6840644;6158060;0.029811;quickSort
358700;1051011709840;227628;6615216;6842844;6159960;0.030426;quickSort
358800;1051083459840;227728;6617316;6845044;6161860;0.029950;quickSort
358900;1051155229840;227828;6619416;6847244;6163760;0.029868;quickSort
359000;106011267648;227928;6621516;6849444;6165660;0.029851;quickSort
359100;106083077648;228028;6623616;6851644;6167560;0.029887;quickSort
359200;106154907648;228128;6625716;6853844;6169460;0.029924;quickSort
359300;106226757648;228228;6627816;6856044;6171360;0.029883;quickSort
359400;106298627648;228328;6629916;6858244;6173260;0.029944;quickSort
359500;106370517648;228428;6632016;6860444;6175160;0.029879;quickSort
359600;106442427648;228528;6634116;6862644;6177060;0.030009;quickSort
359700;106514357648;228628;6636216;6864844;6178960;0.029972;quickSort
359800;106586307648;228728;6638316;6867044;6180860;0.029865;quickSort
359900;106658277648;228828;6640416;6869244;6182760;0.030070;quickSort
360000;106730267648;228928;6642516;6871444;6184660;0.029893;quickSort
360100;106802277648;229028;6644616;6873644;6186560;0.029908;quickSort
360200;106874307648;229128;6646716;6875844;6188460;0.029912;quickSort
360300;106946357648;229228;6648816;6878044;6190360;0.029912;quickSort
360400;1061018427648;229328;6650916;6880244;6192260;0.030346;quickSort
360500;1061090517648;229428;6653016;6882444;6194160;0.029951;quickSort
360600;1061162627648;229528;6655116;6884644;6196060;0.029960;quickSort
360700;107019005456;229628;6657216;6886844;6197960;0.030060;quickSort
360800;107091155456;229728;6659316;6889044;6199860;0.030012;quickSort
360900;107163325456;229828;6661416;6891244;6201760;0.029940;quickSort
361000;107235515456;229928;6663516;6893444;6203660;0.031389;quickSort
361100;107307725456;230028;6665616;6895644;6205560;0.031921;quickSort
361200;107379955456;230128;6667716;6897844;6207460;0.029653;quickSort
361300;107452205456;230228;6669816;6900044;6209360;0.030014;quickSort
361400;107524475456;230328;6671916;6902244;6211260;0.029986;quickSort
361500;107596765456;230428;6674016;6904444;6213160;0.030112;quickSort
361600;107669075456;230528;6676116;6906644;6215060;0.030104;quickSort
361700;107741405456;230628;6678216;6908844;6216960;0.031671;quickSort
361800;107813755456;230728;6680316;6911044;6218860;0.030040;quickSort
361900;107886125456;230828;6682416;6913244;6220760;0.030072;quickSort
362000;107958515456;230928;6684516;6915444;6222660;0.030044;quickSort
362100;1071030925456;231028;6686616;6917644;6224560;0.030081;quickSort
362200;1071103355456;231128;6688716;6919844;6226460;0.030077;quickSort
362300;1071175805456;231228;6690816;6922044;6228360;0.030124;quickSort
362400;108032523264;231328;6692916;6924244;6230260;0.030419;quickSort
362500;108105013264;231428;6695016;6926444;6232160;0.030120;quickSort
362600;108177523264;231528;6697116;6928644;6234060;0.030147;quickSort
362700;108250053264;231628;6699216;6930844;6235960;0.030179;quickSort
362800;108322603264;231728;6701316;6933044;6237860;0.030172;quickSort
362900;108395173264;231828;6703416;6935244;6239760;0.030202;quickSort
363000;108467763264;231928;6705516;6937444;6241660;0.030259;quickSort
363100;108540373264;232028;6707616;6939644;6243560;0.030175;quickSort
363200;108613003264;232128;6709716;6941844;6245460;0.030178;quickSort
363300;108685653264;232228;6711816;6944044;6247360;0.030185;quickSort
363400;108758323264;232328;6713916;6946244;6249260;0.030229;quickSort
363500;108831013264;232428;6716016;6948444;6251160;0.030237;quickSort
363600;108903723264;232528;6718116;6950644;6253060;0.030253;quickSort
363700;108976453264;232628;6720216;6952844;6254960;0.031197;quickSort
363800;1081049203264;232728;6722316;6955044;6256860;0.030333;quickSort
363900;1081121973264;232828;6724416;6957244;6258760;0.030304;quickSort
364000;1081194763264;232928;6726516;6959444;6260660;0.030395;quickSort
364100;109051821072;233028;6728616;6961644;6262560;0.030598;quickSort
364200;109124651072;233128;6730716;6963844;6264460;0.030447;quickSort
364300;109197501072;233228;6732816;6966044;6266360;0.030290;quickSort
364400;109270371072;233328;6734916;6968244;6268260;0.030370;quickSort
364500;109343261072;233428;6737016;6970444;6270160;0.030454;quickSort
364600;109416171072;233528;6739116;6972644;6272060;0.030367;quickSort
364700;109489101072;233628;6741216;6974844;6273960;0.030422;quickSort
364800;109562051072;233728;6743316;6977044;6275860;0.032151;quickSort
364900;109635021072;233828;6745416;6979244;6277760;0.030440;quickSort
365000;109708011072;233928;6747516;6981444;6279660;0.037663;quickSort
365100;109781021072;234028;6749616;6983644;6281560;0.030397;quickSort
365200;109854051072;234128;6751716;6985844;6283460;0.030433;quickSort
365300;109927101072;234228;6753816;6988044;6285360;0.030454;quickSort
365400;1091000171072;234328;6755916;6990244;6287260;0.030422;quickSort
365500;1091073261072;234428;6758016;6992444;6289160;0.030483;quickSort
365600;1091146371072;234528;6760116;6994644;6291060;0.030662;quickSort
365700;110003748880;234628;6762216;6996844;6292960;0.030389;quickSort
365800;110076898880;234728;6764316;6999044;6294860;0.030506;quickSort
365900;110150068880;234828;6766416;7001244;6296760;0.030472;quickSort
366000;110223258880;234928;6768516;7003444;6298660;0.030506;quickSort
366100;110296468880;235028;6770616;7005644;6300560;0.030543;quickSort
366200;110369698880;235128;6772716;7007844;6302460;0.030470;quickSort
366300;110442948880;235228;6774816;7010044;6304360;0.029796;quickSort
366400;110516218880;235328;6776916;7012244;6306260;0.030072;quickSort
366500;110589508880;235428;6779016;7014444;6308160;0.029777;quickSort
366600;110662818880;235528;6781116;7016644;6310060;0.030581;quickSort
366700;110736148880;235628;6783216;7018844;6311960;0.030732;quickSort
366800;110809498880;235728;6785316;7021044;6313860;0.030653;quickSort
366900;110882868880;235828;6787416;7023244;6315760;0.030600;quickSort
367000;110956258880;235928;6789516;7025444;6317660;0.030629;quickSort
367100;1101029668880;236028;6791616;7027644;6319560;0.030656;quickSort
367200;1101103098880;236128;6793716;7029844;6321460;0.030697;quickSort
367300;1101176548880;236228;6795816;7032044;6323360;0.030652;quickSort
367400;111034266688;236328;6797916;7034244;6325260;0.030741;quickSort
367500;111107756688;236428;6800016;7036444;6327160;0.030607;quickSort
367600;111181266688;236528;6802116;7038644;6329060;0.030662;quickSort
367700;111254796688;236628;6804216;7040844;6330960;0.030615;quickSort
367800;111328346688;236728;6806316;7043044;6332860;0.032283;quickSort
367900;111401916688;236828;6808416;7045244;6334760;0.030986;quickSort
368000;111475506688;236928;6810516;7047444;6336660;0.030749;quickSort
368100;111549116688;237028;6812616;7049644;6338560;0.030669;quickSort
368200;111622746688;237128;6814716;7051844;6340460;0.030697;quickSort
368300;111696396688;237228;6816816;7054044;6342360;0.031024;quickSort
368400;111770066688;237328;6818916;7056244;6344260;0.030803;quickSort
368500;111843756688;237428;6821016;7058444;6346160;0.030755;quickSort
368600;111917466688;237528;6823116;7060644;6348060;0.030807;quickSort
368700;111991196688;237628;6825216;7062844;6349960;0.030776;quickSort
368800;1111064946688;237728;6827316;7065044;6351860;0.030752;quickSort
368900;1111138716688;237828;6829416;7067244;6353760;0.030751;quickSort
369000;1111212506688;237928;6831516;7069444;6355660;0.030817;quickSort
369100;112070564496;238028;6833616;7071644;6357560;0.030806;quickSort
369200;112144394496;238128;6835716;7073844;6359460;0.030863;quickSort
369300;112218244496;238228;6837816;7076044;6361360;0.030815;quickSort
369400;112292114496;238328;6839916;7078244;6363260;0.030781;quickSort
369500;112366004496;238428;6842016;7080444;6365160;0.030092;quickSort
369600;112439914496;238528;6844116;7082644;6367060;0.030812;quickSort
369700;112513844496;238628;6846216;7084844;6368960;0.030866;quickSort
369800;112587794496;238728;6848316;7087044;6370860;0.030868;quickSort
369900;112661764496;238828;6850416;7089244;6372760;0.030930;quickSort
370000;112735754496;238928;6852516;7091444;6374660;0.030856;quickSort
370100;112809764496;239028;6854616;7093644;6376560;0.030905;quickSort
370200;112883794496;239128;6856716;7095844;6378460;0.031905;quickSort
370300;112957844496;239228;6858816;7098044;6380360;0.030162;quickSort
370400;1121031914496;239328;6860916;7100244;6382260;0.030962;quickSort
370500;1121106004496;239428;6863016;7102444;6384160;0.030943;quickSort
370600;1121180114496;239528;6865116;7104644;6386060;0.030955;quickSort
370700;113038492304;239628;6867216;7106844;6387960;0.030925;quickSort
370800;113112642304;239728;6869316;7109044;6389860;0.031603;quickSort
370900;113186812304;239828;6871416;7111244;6391760;0.032012;quickSort
371000;113261002304;239928;6873516;7113444;6393660;0.030911;quickSort
371100;113335212304;240028;6875616;7115644;6395560;0.032655;quickSort
371200;113409442304;240128;6877716;7117844;6397460;0.033360;quickSort
371300;113483692304;240228;6879816;7120044;6399360;0.032470;quickSort
371400;113557962304;240328;6881916;7122244;6401260;0.031500;quickSort
371500;113632252304;240428;6884016;7124444;6403160;0.031622;quickSort
371600;113706562304;240528;6886116;7126644;6405060;0.031678;quickSort
371700;113780892304;240628;6888216;7128844;6406960;0.031001;quickSort
371800;113855242304;240728;6890316;7131044;6408860;0.030368;quickSort
371900;113929612304;240828;6892416;7133244;6410760;0.030962;quickSort
372000;1131004002304;240928;6894516;7135444;6412660;0.031307;quickSort
372100;1131078412304;241028;6896616;7137644;6414560;0.031231;quickSort
372200;1131152842304;241128;6898716;7139844;6416460;0.032531;quickSort
372300;114011540112;241228;6900816;7142044;6418360;0.031727;quickSort
372400;114086010112;241328;6902916;7144244;6420260;0.031262;quickSort
372500;114160500112;241428;6905016;7146444;6422160;0.031236;quickSort
372600;114235010112;241528;6907116;7148644;6424060;0.031141;quickSort
372700;114309540112;241628;6909216;7150844;6425960;0.031122;quickSort
372800;114384090112;241728;6911316;7153044;6427860;0.031159;quickSort
372900;114458660112;241828;6913416;7155244;6429760;0.031182;quickSort
373000;114533250112;241928;6915516;7157444;6431660;0.031182;quickSort
373100;114607860112;242028;6917616;7159644;6433560;0.031303;quickSort
373200;114682490112;242128;6919716;7161844;6435460;0.032761;quickSort
373300;114757140112;242228;6921816;7164044;6437360;0.031232;quickSort
373400;114831810112;242328;6923916;7166244;6439260;0.032361;quickSort
373500;114906500112;242428;6926016;7168444;6441160;0.031393;quickSort
373600;114981210112;242528;6928116;7170644;6443060;0.031271;quickSort
373700;1141055940112;242628;6930216;7172844;6444960;0.031266;quickSort
373800;1141130690112;242728;6932316;7175044;6446860;0.032361;quickSort
373900;1141205460112;242828;6934416;7177244;6448760;0.031363;quickSort
374000;115064497920;242928;6936516;7179444;6450660;0.031311;quickSort
374100;115139307920;243028;6938616;7181644;6452560;0.031266;quickSort
374200;115214137920;243128;6940716;7183844;6454460;0.031327;quickSort
374300;115288987920;243228;6942816;7186044;6456360;0.030909;quickSort
374400;115363857920;243328;6944916;7188244;6458260;0.030580;quickSort
374500;115438747920;243428;6947016;7190444;6460160;0.031012;quickSort
374600;115513657920;243528;6949116;7192644;6462060;0.031320;quickSort
374700;115588587920;243628;6951216;7194844;6463960;0.031323;quickSort
374800;115663537920;243728;6953316;7197044;6465860;0.031297;quickSort
374900;115738507920;243828;6955416;7199244;6467760;0.031378;quickSort
375000;115813497920;243928;6957516;7201444;6469660;0.031379;quickSort
375100;115888507920;244028;6959616;7203644;6471560;0.033072;quickSort
375200;115963537920;244128;6961716;7205844;6473460;0.031348;quickSort
375300;1151038587920;244228;6963816;7208044;6475360;0.031439;quickSort
375400;1151113657920;244328;6965916;7210244;6477260;0.030681;quickSort
375500;1151188747920;244428;6968016;7212444;6479160;0.030654;quickSort
375600;116048105728;244528;6970116;7214644;6481060;0.030670;quickSort
375700;116123235728;244628;6972216;7216844;6482960;0.031410;quickSort
375800;116198385728;244728;6974316;7219044;6484860;0.031428;quickSort
375900;116273555728;244828;6976416;7221244;6486760;0.031482;quickSort
376000;116348745728;244928;6978516;7223444;6488660;0.031439;quickSort
376100;116423955728;245028;6980616;7225644;6490560;0.031453;quickSort
376200;116499185728;245128;6982716;7227844;6492460;0.032243;quickSort
376300;116574435728;245228;6984816;7230044;6494360;0.031466;quickSort
376400;116649705728;245328;6986916;7232244;6496260;0.031490;quickSort
376500;116724995728;245428;6989016;7234444;6498160;0.031494;quickSort
376600;116800305728;245528;6991116;7236644;6500060;0.031490;quickSort
376700;116875635728;245628;6993216;7238844;6501960;0.031914;quickSort
376800;116950985728;245728;6995316;7241044;6503860;0.032095;quickSort
376900;1161026355728;245828;6997416;7243244;6505760;0.031729;quickSort
377000;1161101745728;245928;6999516;7245444;6507660;0.031575;quickSort
377100;1161177155728;246028;7001616;7247644;6509560;0.031547;quickSort
377200;117036833536;246128;7003716;7249844;6511460;0.031604;quickSort
377300;117112283536;246228;7005816;7252044;6513360;0.031623;quickSort
377400;117187753536;246328;7007916;7254244;6515260;0.032771;quickSort
377500;117263243536;246428;7010016;7256444;6517160;0.033377;quickSort
377600;117338753536;246528;7012116;7258644;6519060;0.032751;quickSort
377700;117414283536;246628;7014216;7260844;6520960;0.031867;quickSort
377800;117489833536;246728;7016316;7263044;6522860;0.033238;quickSort
377900;117565403536;246828;7018416;7265244;6524760;0.035116;quickSort
378000;117640993536;246928;7020516;7267444;6526660;0.031583;quickSort
378100;117716603536;247028;7022616;7269644;6528560;0.031694;quickSort
378200;117792233536;247128;7024716;7271844;6530460;0.031767;quickSort
378300;117867883536;247228;7026816;7274044;6532360;0.032575;quickSort
378400;117943553536;247328;7028916;7276244;6534260;0.031772;quickSort
378500;1171019243536;247428;7031016;7278444;6536160;0.031690;quickSort
378600;1171094953536;247528;7033116;7280644;6538060;0.032094;quickSort
378700;1171170683536;247628;7035216;7282844;6539960;0.031757;quickSort
378800;118030681344;247728;7037316;7285044;6541860;0.031704;quickSort
378900;118106451344;247828;7039416;7287244;6543760;0.031786;quickSort
379000;118182241344;247928;7041516;7289444;6545660;0.031743;quickSort
379100;118258051344;248028;7043616;7291644;6547560;0.031856;quickSort
379200;118333881344;248128;7045716;7293844;6549460;0.031781;quickSort
379300;118409731344;248228;7047816;7296044;6551360;0.031819;quickSort
379400;118485601344;248328;7049916;7298244;6553260;0.031822;quickSort
379500;118561491344;248428;7052016;7300444;6555160;0.032221;quickSort
379600;118637401344;248528;7054116;7302644;6557060;0.032333;quickSort
379700;118713331344;248628;7056216;7304844;6558960;0.031906;quickSort
379800;118789281344;248728;7058316;7307044;6560860;0.032127;quickSort
379900;118865251344;248828;7060416;7309244;6562760;0.032278;quickSort
380000;118941241344;248928;7062516;7311444;6564660;0.032107;quickSort
380100;1181017251344;249028;7064616;7313644;6566560;0.032511;quickSort
380200;1181093281344;249128;7066716;7315844;6568460;0.032696;quickSort
380300;1181169331344;249228;7068816;7318044;6570360;0.032490;quickSort
380400;119029649152;249328;7070916;7320244;6572260;0.031977;quickSort
380500;119105739152;249428;7073016;7322444;6574160;0.031926;quickSort
380600;119181849152;249528;7075116;7324644;6576060;0.031968;quickSort
380700;119257979152;249628;7077216;7326844;6577960;0.032318;quickSort
380800;119334129152;249728;7079316;7329044;6579860;0.033056;quickSort
380900;119410299152;249828;7081416;7331244;6581760;0.031991;quickSort
381000;119486489152;249928;7083516;7333444;6583660;0.032243;quickSort
381100;119562699152;250028;7085616;7335644;6585560;0.032181;quickSort
381200;119638929152;250128;7087716;7337844;6587460;0.033223;quickSort
381300;119715179152;250228;7089816;7340044;6589360;0.033704;quickSort
381400;119791449152;250328;7091916;7342244;6591260;0.032067;quickSort
381500;119867739152;250428;7094016;7344444;6593160;0.032148;quickSort
381600;119944049152;250528;7096116;7346644;6595060;0.032089;quickSort
381700;1191020379152;250628;7098216;7348844;6596960;0.032560;quickSort
381800;1191096729152;250728;7100316;7351044;6598860;0.032442;quickSort
381900;1191173099152;250828;7102416;7353244;6600760;0.033987;quickSort
382000;120033736960;250928;7104516;7355444;6602660;0.037958;quickSort
382100;120110146960;251028;7106616;7357644;6604560;0.032653;quickSort
382200;120186576960;251128;7108716;7359844;6606460;0.032901;quickSort
382300;120263026960;251228;7110816;7362044;6608360;0.032791;quickSort
382400;120339496960;251328;7112916;7364244;6610260;0.032689;quickSort
382500;120415986960;251428;7115016;7366444;6612160;0.033013;quickSort
382600;120492496960;251528;7117116;7368644;6614060;0.032170;quickSort
382700;120569026960;251628;7119216;7370844;6615960;0.032277;quickSort
382800;120645576960;251728;7121316;7373044;6617860;0.032256;quickSort
382900;120722146960;251828;7123416;7375244;6619760;0.032649;quickSort
383000;120798736960;251928;7125516;7377444;6621660;0.032443;quickSort
383100;120875346960;252028;7127616;7379644;6623560;0.032491;quickSort
383200;120951976960;252128;7129716;7381844;6625460;0.032252;quickSort
383300;1201028626960;252228;7131816;7384044;6627360;0.032224;quickSort
383400;1201105296960;252328;7133916;7386244;6629260;0.032252;quickSort
383500;1201181986960;252428;7136016;7388444;6631160;0.032290;quickSort
383600;121042944768;252528;7138116;7390644;6633060;0.032271;quickSort
383700;121119674768;252628;7140216;7392844;6634960;0.032253;quickSort
383800;121196424768;252728;7142316;7395044;6636860;0.032265;quickSort
383900;121273194768;252828;7144416;7397244;6638760;0.032185;quickSort
384000;121349984768;252928;7146516;7399444;6640660;0.032254;quickSort
384100;121426794768;253028;7148616;7401644;6642560;0.032291;quickSort
384200;121503624768;253128;7150716;7403844;6644460;0.032318;quickSort
384300;121580474768;253228;7152816;7406044;6646360;0.032327;quickSort
384400;121657344768;253328;7154916;7408244;6648260;0.032331;quickSort
384500;121734234768;253428;7157016;7410444;6650160;0.032359;quickSort
384600;121811144768;253528;7159116;7412644;6652060;0.032304;quickSort
384700;121888074768;253628;7161216;7414844;6653960;0.032385;quickSort
384800;121965024768;253728;7163316;7417044;6655860;0.032341;quickSort
384900;1211041994768;253828;7165416;7419244;6657760;0.032434;quickSort
385000;1211118984768;253928;7167516;7421444;6659660;0.032345;quickSort
385100;1211195994768;254028;7169616;7423644;6661560;0.032419;quickSort
385200;122057272576;254128;7171716;7425844;6663460;0.032424;quickSort
385300;122134322576;254228;7173816;7428044;6665360;0.032491;quickSort
385400;122211392576;254328;7175916;7430244;6667260;0.032428;quickSort
385500;122288482576;254428;7178016;7432444;6669160;0.032467;quickSort
385600;122365592576;254528;7180116;7434644;6671060;0.032410;quickSort
385700;122442722576;254628;7182216;7436844;6672960;0.032497;quickSort
385800;122519872576;254728;7184316;7439044;6674860;0.032486;quickSort
385900;122597042576;254828;7186416;7441244;6676760;0.032446;quickSort
386000;122674232576;254928;7188516;7443444;6678660;0.032477;quickSort
386100;122751442576;255028;7190616;7445644;6680560;0.032507;quickSort
386200;122828672576;255128;7192716;7447844;6682460;0.032466;quickSort
386300;122905922576;255228;7194816;7450044;6684360;0.032502;quickSort
386400;122983192576;255328;7196916;7452244;6686260;0.032526;quickSort
386500;1221060482576;255428;7199016;7454444;6688160;0.032601;quickSort
386600;1221137792576;255528;7201116;7456644;6690060;0.033512;quickSort
386700;1221215122576;255628;7203216;7458844;6691960;0.032595;quickSort
386800;123076720384;255728;7205316;7461044;6693860;0.032626;quickSort
386900;123154090384;255828;7207416;7463244;6695760;0.032516;quickSort
387000;123231480384;255928;7209516;7465444;6697660;0.032612;quickSort
387100;123308890384;256028;7211616;7467644;6699560;0.032646;quickSort
387200;123386320384;256128;7213716;7469844;6701460;0.032557;quickSort
387300;123463770384;256228;7215816;7472044;6703360;0.032634;quickSort
387400;123541240384;256328;7217916;7474244;6705260;0.032841;quickSort
387500;123618730384;256428;7220016;7476444;6707160;0.032598;quickSort
387600;123696240384;256528;7222116;7478644;6709060;0.032709;quickSort
387700;123773770384;256628;7224216;7480844;6710960;0.033925;quickSort
387800;123851320384;256728;7226316;7483044;6712860;0.033612;quickSort
387900;123928890384;256828;7228416;7485244;6714760;0.032603;quickSort
388000;1231006480384;256928;7230516;7487444;6716660;0.032821;quickSort
388100;1231084090384;257028;7232616;7489644;6718560;0.033284;quickSort
388200;1231161720384;257128;7234716;7491844;6720460;0.033161;quickSort
388300;124023618192;257228;7236816;7494044;6722360;0.032831;quickSort
388400;124101288192;257328;7238916;7496244;6724260;0.032876;quickSort
388500;124178978192;257428;7241016;7498444;6726160;0.032749;quickSort
388600;124256688192;257528;7243116;7500644;6728060;0.033061;quickSort
388700;124334418192;257628;7245216;7502844;6729960;0.033136;quickSort
388800;124412168192;257728;7247316;7505044;6731860;0.032819;quickSort
388900;124489938192;257828;7249416;7507244;6733760;0.032758;quickSort
389000;124567728192;257928;7251516;7509444;6735660;0.032749;quickSort
389100;124645538192;258028;7253616;7511644;6737560;0.032745;quickSort
389200;124723368192;258128;7255716;7513844;6739460;0.033139;quickSort
389300;124801218192;258228;7257816;7516044;6741360;0.033215;quickSort
389400;124879088192;258328;7259916;7518244;6743260;0.032864;quickSort
389500;124956978192;258428;7262016;7520444;6745160;0.032822;quickSort
389600;1241034888192;258528;7264116;7522644;6747060;0.032868;quickSort
389700;1241112818192;258628;7266216;7524844;6748960;0.032839;quickSort
389800;1241190768192;258728;7268316;7527044;6750860;0.032919;quickSort
389900;125052986000;258828;7270416;7529244;6752760;0.032939;quickSort
390000;125130976000;258928;7272516;7531444;6754660;0.032960;quickSort
390100;125208986000;259028;7274616;7533644;6756560;0.032933;quickSort
390200;125287016000;259128;7276716;7535844;6758460;0.033065;quickSort
390300;125365066000;259228;7278816;7538044;6760360;0.033498;quickSort
390400;125443136000;259328;7280916;7540244;6762260;0.032954;quickSort
390500;125521226000;259428;7283016;7542444;6764160;0.033182;quickSort
390600;125599336000;259528;7285116;7544644;6766060;0.032928;quickSort
390700;125677466000;259628;7287216;7546844;6767960;0.033005;quickSort
390800;125755616000;259728;7289316;7549044;6769860;0.033089;quickSort
390900;125833786000;259828;7291416;7551244;6771760;0.032252;quickSort
391000;125911976000;259928;7293516;7553444;6773660;0.032742;quickSort
391100;125990186000;260028;7295616;7555644;6775560;0.032986;quickSort
391200;1251068416000;260128;7297716;7557844;6777460;0.032980;quickSort
391300;1251146666000;260228;7299816;7560044;6779360;0.033038;quickSort
391400;126009183808;260328;7301916;7562244;6781260;0.033068;quickSort
391500;126087473808;260428;7304016;7564444;6783160;0.033024;quickSort
391600;126165783808;260528;7306116;7566644;6785060;0.032671;quickSort
391700;126244113808;260628;7308216;7568844;6786960;0.032201;quickSort
391800;126322463808;260728;7310316;7571044;6788860;0.033018;quickSort
391900;126400833808;260828;7312416;7573244;6790760;0.033152;quickSort
392000;126479223808;260928;7314516;7575444;6792660;0.034040;quickSort
392100;126557633808;261028;7316616;7577644;6794560;0.035637;quickSort
392200;126636063808;261128;7318716;7579844;6796460;0.033422;quickSort
392300;126714513808;261228;7320816;7582044;6798360;0.033264;quickSort
392400;126792983808;261328;7322916;7584244;6800260;0.039587;quickSort
392500;126871473808;261428;7325016;7586444;6802160;0.033386;quickSort
392600;126949983808;261528;7327116;7588644;6804060;0.040804;quickSort
392700;1261028513808;261628;7329216;7590844;6805960;0.038727;quickSort
392800;1261107063808;261728;7331316;7593044;6807860;0.041204;quickSort
392900;1261185633808;261828;7333416;7595244;6809760;0.033656;quickSort
393000;127048471616;261928;7335516;7597444;6811660;0.035777;quickSort
393100;127127081616;262028;7337616;7599644;6813560;0.034701;quickSort
393200;127205711616;262128;7339716;7601844;6815460;0.035339;quickSort
393300;127284361616;262143;7341561;7603704;6817275;0.033914;quickSort
393400;127363031616;262143;7343361;7605504;6819075;0.034334;quickSort
393500;127441721616;262143;7345161;7607304;6820875;0.036548;quickSort
393600;127520431616;262143;7346961;7609104;6822675;0.034049;quickSort
393700;127599161616;262143;7348761;7610904;6824475;0.034472;quickSort
393800;127677911616;262143;7350561;7612704;6826275;0.033884;quickSort
393900;127756681616;262143;7352361;7614504;6828075;0.034314;quickSort
394000;127835471616;262143;7354161;7616304;6829875;0.033329;quickSort
394100;127914281616;262143;7355961;7618104;6831675;0.033333;quickSort
394200;127993111616;262143;7357761;7619904;6833475;0.033311;quickSort
394300;1271071961616;262143;7359561;7621704;6835275;0.034741;quickSort
394400;1271150831616;262143;7361361;7623504;6837075;0.034219;quickSort
394500;128013969424;262143;7363161;7625304;6838875;0.033578;quickSort
394600;128092879424;262143;7364961;7627104;6840675;0.033550;quickSort
394700;128171809424;262143;7366761;7628904;6842475;0.034004;quickSort
394800;128250759424;262143;7368561;7630704;6844275;0.035722;quickSort
394900;128329729424;262143;7370361;7632504;6846075;0.034628;quickSort
395000;128408719424;262143;7372161;7634304;6847875;0.034106;quickSort
395100;128487729424;262143;7373961;7636104;6849675;0.035156;quickSort
395200;128566759424;262143;7375761;7637904;6851475;0.036105;quickSort
395300;128645809424;262143;7377561;7639704;6853275;0.033472;quickSort
395400;128724879424;262143;7379361;7641504;6855075;0.033424;quickSort
395500;128803969424;262143;7381161;7643304;6856875;0.033462;quickSort
395600;128883079424;262143;7382961;7645104;6858675;0.033395;quickSort
395700;128962209424;262143;7384761;7646904;6860475;0.033395;quickSort
395800;1281041359424;262143;7386561;7648704;6862275;0.033396;quickSort
395900;1281120529424;262143;7388361;7650504;6864075;0.033454;quickSort
396000;1281199719424;262143;7390161;7652304;6865875;0.033435;quickSort
396100;129063177232;262143;7391961;7654104;6867675;0.035213;quickSort
396200;129142407232;262143;7393761;7655904;6869475;0.038717;quickSort
396300;129221657232;262143;7395561;7657704;6871275;0.035596;quickSort
396400;129300927232;262143;7397361;7659504;6873075;0.033623;quickSort
396500;129380217232;262143;7399161;7661304;6874875;0.033542;quickSort
396600;129459527232;262143;7400961;7663104;6876675;0.033692;quickSort
396700;129538857232;262143;7402761;7664904;6878475;0.033511;quickSort
396800;129618207232;262143;7404561;7666704;6880275;0.033543;quickSort
396900;129697577232;262143;7406361;7668504;6882075;0.033598;quickSort
397000;129776967232;262143;7408161;7670304;6883875;0.033669;quickSort
397100;129856377232;262143;7409961;7672104;6885675;0.033518;quickSort
397200;129935807232;262143;7411761;7673904;6887475;0.033547;quickSort
397300;1291015257232;262143;7413561;7675704;6889275;0.033623;quickSort
397400;1291094727232;262143;7415361;7677504;6891075;0.033703;quickSort
397500;1291174217232;262143;7417161;7679304;6892875;0.033641;quickSort
397600;130037975040;262143;7418961;7681104;6894675;0.033686;quickSort
397700;130117505040;262143;7420761;7682904;6896475;0.033607;quickSort
397800;130197055040;262143;7422561;7684704;6898275;0.033838;quickSort
397900;130276625040;262143;7424361;7686504;6900075;0.033828;quickSort
398000;130356215040;262143;7426161;7688304;6901875;0.033695;quickSort
398100;130435825040;262143;7427961;7690104;6903675;0.033657;quickSort
398200;130515455040;262143;7429761;7691904;6905475;0.033723;quickSort
398300;130595105040;262143;7431561;7693704;6907275;0.033673;quickSort
398400;130674775040;262143;7433361;7695504;6909075;0.033633;quickSort
398500;130754465040;262143;7435161;7697304;6910875;0.033671;quickSort
398600;130834175040;262143;7436961;7699104;6912675;0.033712;quickSort
398700;130913905040;262143;7438761;7700904;6914475;0.033825;quickSort
398800;130993655040;262143;7440561;7702704;6916275;0.034634;quickSort
398900;1301073425040;262143;7442361;7704504;6918075;0.035074;quickSort
399000;1301153215040;262143;7444161;7706304;6919875;0.034522;quickSort
399100;131017272848;262143;7445961;7708104;6921675;0.034156;quickSort
399200;131097102848;262143;7447761;7709904;6923475;0.033866;quickSort
399300;131176952848;262143;7449561;7711704;6925275;0.035062;quickSort
399400;131256822848;262143;7451361;7713504;6927075;0.037758;quickSort
399500;131336712848;262143;7453161;7715304;6928875;0.035715;quickSort
399600;131416622848;262143;7454961;7717104;6930675;0.035963;quickSort
399700;131496552848;262143;7456761;7718904;6932475;0.034078;quickSort
399800;131576502848;262143;7458561;7720704;6934275;0.034333;quickSort
399900;131656472848;262143;7460361;7722504;6936075;0.034125;quickSort
400000;131736462848;262143;7462161;7724304;6937875;0.033771;quickSort
400100;131816472848;262143;7463961;7726104;6939675;0.033857;quickSort
400200;131896502848;262143;7465761;7727904;6941475;0.033816;quickSort
400300;131976552848;262143;7467561;7729704;6943275;0.033835;quickSort
400400;1311056622848;262143;7469361;7731504;6945075;0.033822;quickSort
400500;1311136712848;262143;7471161;7733304;6946875;0.033878;quickSort
400600;132001070656;262143;7472961;7735104;6948675;0.033881;quickSort
400700;132081200656;262143;7474761;7736904;6950475;0.034919;quickSort
400800;132161350656;262143;7476561;7738704;6952275;0.034797;quickSort
400900;132241520656;262143;7478361;7740504;6954075;0.034551;quickSort
401000;132321710656;262143;7480161;7742304;6955875;0.034184;quickSort
401100;132401920656;262143;7481961;7744104;6957675;0.034182;quickSort
401200;132482150656;262143;7483761;7745904;6959475;0.034166;quickSort
401300;132562400656;262143;7485561;7747704;6961275;0.034127;quickSort
401400;132642670656;262143;7487361;7749504;6963075;0.034251;quickSort
401500;132722960656;262143;7489161;7751304;6964875;0.034432;quickSort
401600;132803270656;262143;7490961;7753104;6966675;0.034565;quickSort
401700;132883600656;262143;7492761;7754904;6968475;0.036399;quickSort
401800;132963950656;262143;7494561;7756704;6970275;0.034688;quickSort
401900;1321044320656;262143;7496361;7758504;6972075;0.037306;quickSort
402000;1321124710656;262143;7498161;7760304;6973875;0.033456;quickSort
402100;1321205120656;262143;7499961;7762104;6975675;0.033304;quickSort
402200;133069798464;262143;7501761;7763904;6977475;0.034029;quickSort
402300;133150248464;262143;7503561;7765704;6979275;0.034022;quickSort
402400;133230718464;262143;7505361;7767504;6981075;0.034059;quickSort
402500;133311208464;262143;7507161;7769304;6982875;0.034084;quickSort
402600;133391718464;262143;7508961;7771104;6984675;0.034094;quickSort
402700;133472248464;262143;7510761;7772904;6986475;0.034033;quickSort
402800;133552798464;262143;7512561;7774704;6988275;0.034072;quickSort
402900;133633368464;262143;7514361;7776504;6990075;0.034111;quickSort
403000;133713958464;262143;7516161;7778304;6991875;0.034074;quickSort
403100;133794568464;262143;7517961;7780104;6993675;0.034146;quickSort
403200;133875198464;262143;7519761;7781904;6995475;0.034097;quickSort
403300;133955848464;262143;7521561;7783704;6997275;0.034085;quickSort
403400;1331036518464;262143;7523361;7785504;6999075;0.034088;quickSort
403500;1331117208464;262143;7525161;7787304;7000875;0.034167;quickSort
403600;1331197918464;262143;7526961;7789104;7002675;0.034139;quickSort
403700;134062896272;262143;7528761;7790904;7004475;0.034177;quickSort
403800;134143646272;262143;7530561;7792704;7006275;0.034200;quickSort
403900;134224416272;262143;7532361;7794504;7008075;0.034301;quickSort
404000;134305206272;262143;7534161;7796304;7009875;0.034159;quickSort
404100;134386016272;262143;7535961;7798104;7011675;0.035411;quickSort
404200;134466846272;262143;7537761;7799904;7013475;0.034180;quickSort
404300;134547696272;262143;7539561;7801704;7015275;0.034459;quickSort
404400;134628566272;262143;7541361;7803504;7017075;0.034181;quickSort
404500;134709456272;262143;7543161;7805304;7018875;0.034166;quickSort
404600;134790366272;262143;7544961;7807104;7020675;0.034152;quickSort
404700;134871296272;262143;7546761;7808904;7022475;0.034156;quickSort
404800;134952246272;262143;7548561;7810704;7024275;0.034289;quickSort
404900;1341033216272;262143;7550361;7812504;7026075;0.034292;quickSort
405000;1341114206272;262143;7552161;7814304;7027875;0.034332;quickSort
405100;1341195216272;262143;7553961;7816104;7029675;0.034268;quickSort
405200;135060494080;262143;7555761;7817904;7031475;0.034202;quickSort
405300;135141544080;262143;7557561;7819704;7033275;0.034273;quickSort
405400;135222614080;262143;7559361;7821504;7035075;0.034338;quickSort
405500;135303704080;262143;7561161;7823304;7036875;0.034317;quickSort
405600;135384814080;262143;7562961;7825104;7038675;0.034304;quickSort
405700;135465944080;262143;7564761;7826904;7040475;0.034261;quickSort
405800;135547094080;262143;7566561;7828704;7042275;0.034307;quickSort
405900;135628264080;262143;7568361;7830504;7044075;0.034283;quickSort
406000;135709454080;262143;7570161;7832304;7045875;0.034380;quickSort
406100;135790664080;262143;7571961;7834104;7047675;0.034692;quickSort
406200;135871894080;262143;7573761;7835904;7049475;0.034614;quickSort
406300;135953144080;262143;7575561;7837704;7051275;0.034334;quickSort
406400;1351034414080;262143;7577361;7839504;7053075;0.034432;quickSort
406500;1351115704080;262143;7579161;7841304;7054875;0.034387;quickSort
406600;1351197014080;262143;7580961;7843104;7056675;0.034614;quickSort
406700;136062591888;262143;7582761;7844904;7058475;0.034758;quickSort
406800;136143941888;262143;7584561;7846704;7060275;0.036554;quickSort
406900;136225311888;262143;7586361;7848504;7062075;0.034419;quickSort
407000;136306701888;262143;7588161;7850304;7063875;0.034496;quickSort
407100;136388111888;262143;7589961;7852104;7065675;0.035108;quickSort
407200;136469541888;262143;7591761;7853904;7067475;0.034545;quickSort
407300;136550991888;262143;7593561;7855704;7069275;0.035597;quickSort
407400;136632461888;262143;7595361;7857504;7071075;0.034457;quickSort
407500;136713951888;262143;7597161;7859304;7072875;0.035530;quickSort
407600;136795461888;262143;7598961;7861104;7074675;0.034488;quickSort
407700;136876991888;262143;7600761;7862904;7076475;0.034582;quickSort
407800;136958541888;262143;7602561;7864704;7078275;0.034482;quickSort
407900;1361040111888;262143;7604361;7866504;7080075;0.034497;quickSort
408000;1361121701888;262143;7606161;7868304;7081875;0.034521;quickSort
408100;1361203311888;262143;7607961;7870104;7083675;0.034534;quickSort
408200;137069189696;262143;7609761;7871904;7085475;0.034630;quickSort
408300;137150839696;262143;7611561;7873704;7087275;0.034516;quickSort
408400;137232509696;262143;7613361;7875504;7089075;0.034500;quickSort
408500;137314199696;262143;7615161;7877304;7090875;0.034538;quickSort
408600;137395909696;262143;7616961;7879104;7092675;0.034584;quickSort
408700;137477639696;262143;7618761;7880904;7094475;0.034598;quickSort
408800;137559389696;262143;7620561;7882704;7096275;0.034715;quickSort
408900;137641159696;262143;7622361;7884504;7098075;0.034642;quickSort
409000;137722949696;262143;7624161;7886304;7099875;0.034565;quickSort
409100;137804759696;262143;7625961;7888104;7101675;0.034655;quickSort
409200;137886589696;262143;7627761;7889904;7103475;0.034708;quickSort
409300;137968439696;262143;7629561;7891704;7105275;0.034864;quickSort
409400;1371050309696;262143;7631361;7893504;7107075;0.034735;quickSort
409500;1371132199696;262143;7633161;7895304;7108875;0.035550;quickSort
409600;1371214109696;262143;7634961;7897104;7110675;0.034694;quickSort
409700;138080287504;262143;7636761;7898904;7112475;0.034659;quickSort
409800;138162237504;262143;7638561;7900704;7114275;0.036170;quickSort
409900;138244207504;262143;7640361;7902504;7116075;0.035086;quickSort
410000;138326197504;262143;7642161;7904304;7117875;0.034619;quickSort
410100;138408207504;262143;7643961;7906104;7119675;0.034709;quickSort
410200;138490237504;262143;7645761;7907904;7121475;0.034645;quickSort
410300;138572287504;262143;7647561;7909704;7123275;0.034667;quickSort
410400;138654357504;262143;7649361;7911504;7125075;0.034756;quickSort
410500;138736447504;262143;7651161;7913304;7126875;0.034688;quickSort
410600;138818557504;262143;7652961;7915104;7128675;0.034722;quickSort
410700;138900687504;262143;7654761;7916904;7130475;0.034691;quickSort
410800;138982837504;262143;7656561;7918704;7132275;0.034661;quickSort
410900;1381065007504;262143;7658361;7920504;7134075;0.034731;quickSort
411000;1381147197504;262143;7660161;7922304;7135875;0.034751;quickSort
411100;139013655312;262143;7661961;7924104;7137675;0.034758;quickSort
411200;139095885312;262143;7663761;7925904;7139475;0.034762;quickSort
411300;139178135312;262143;7665561;7927704;7141275;0.034780;quickSort
411400;139260405312;262143;7667361;7929504;7143075;0.034803;quickSort
411500;139342695312;262143;7669161;7931304;7144875;0.034829;quickSort
411600;139425005312;262143;7670961;7933104;7146675;0.034848;quickSort
411700;139507335312;262143;7672761;7934904;7148475;0.034824;quickSort
411800;139589685312;262143;7674561;7936704;7150275;0.034816;quickSort
411900;139672055312;262143;7676361;7938504;7152075;0.034820;quickSort
412000;139754445312;262143;7678161;7940304;7153875;0.034855;quickSort
412100;139836855312;262143;7679961;7942104;7155675;0.034852;quickSort
412200;139919285312;262143;7681761;7943904;7157475;0.034849;quickSort
412300;1391001735312;262143;7683561;7945704;7159275;0.034853;quickSort
412400;1391084205312;262143;7685361;7947504;7161075;0.034879;quickSort
412500;1391166695312;262143;7687161;7949304;7162875;0.035352;quickSort
412600;140033453120;262143;7688961;7951104;7164675;0.035703;quickSort
412700;140115983120;262143;7690761;7952904;7166475;0.034896;quickSort
412800;140198533120;262143;7692561;7954704;7168275;0.034945;quickSort
412900;140281103120;262143;7694361;7956504;7170075;0.034831;quickSort
413000;140363693120;262143;7696161;7958304;7171875;0.034842;quickSort
413100;140446303120;262143;7697961;7960104;7173675;0.034854;quickSort
413200;140528933120;262143;7699761;7961904;7175475;0.034921;quickSort
413300;140611583120;262143;7701561;7963704;7177275;0.034902;quickSort
413400;140694253120;262143;7703361;7965504;7179075;0.034884;quickSort
413500;140776943120;262143;7705161;7967304;7180875;0.035676;quickSort
413600;140859653120;262143;7706961;7969104;7182675;0.034958;quickSort
413700;140942383120;262143;7708761;7970904;7184475;0.035340;quickSort
413800;1401025133120;262143;7710561;7972704;7186275;0.034992;quickSort
413900;1401107903120;262143;7712361;7974504;7188075;0.034975;quickSort
414000;1401190693120;262143;7714161;7976304;7189875;0.034964;quickSort
414100;141057750928;262143;7715961;7978104;7191675;0.034991;quickSort
414200;141140580928;262143;7717761;7979904;7193475;0.035045;quickSort
414300;141223430928;262143;7719561;7981704;7195275;0.035039;quickSort
414400;141306300928;262143;7721361;7983504;7197075;0.034958;quickSort
414500;141389190928;262143;7723161;7985304;7198875;0.034239;quickSort
414600;141472100928;262143;7724961;7987104;7200675;0.034638;quickSort
414700;141555030928;262143;7726761;7988904;7202475;0.035071;quickSort
414800;141637980928;262143;7728561;7990704;7204275;0.035054;quickSort
414900;141720950928;262143;7730361;7992504;7206075;0.035089;quickSort
415000;141803940928;262143;7732161;7994304;7207875;0.035103;quickSort
415100;141886950928;262143;7733961;7996104;7209675;0.035295;quickSort
415200;141969980928;262143;7735761;7997904;7211475;0.035228;quickSort
415300;1411053030928;262143;7737561;7999704;7213275;0.035089;quickSort
415400;1411136100928;262143;7739361;8001504;7215075;0.035038;quickSort
415500;142003438736;262143;7741161;8003304;7216875;0.035062;quickSort
415600;142086548736;262143;7742961;8005104;7218675;0.035106;quickSort
415700;142169678736;262143;7744761;8006904;7220475;0.035106;quickSort
415800;142252828736;262143;7746561;8008704;7222275;0.035058;quickSort
415900;142335998736;262143;7748361;8010504;7224075;0.035179;quickSort
416000;142419188736;262143;7750161;8012304;7225875;0.035087;quickSort
416100;142502398736;262143;7751961;8014104;7227675;0.035172;quickSort
416200;142585628736;262143;7753761;8015904;7229475;0.036000;quickSort
416300;142668878736;262143;7755561;8017704;7231275;0.035069;quickSort
416400;142752148736;262143;7757361;8019504;7233075;0.035306;quickSort
416500;142835438736;262143;7759161;8021304;7234875;0.036931;quickSort
416600;142918748736;262143;7760961;8023104;7236675;0.035167;quickSort
416700;1421002078736;262143;7762761;8024904;7238475;0.035155;quickSort
416800;1421085428736;262143;7764561;8026704;7240275;0.035136;quickSort
416900;1421168798736;262143;7766361;8028504;7242075;0.035162;quickSort
417000;143036436544;262143;7768161;8030304;7243875;0.035185;quickSort
417100;143119846544;262143;7769961;8032104;7245675;0.035187;quickSort
417200;143203276544;262143;7771761;8033904;7247475;0.035229;quickSort
417300;143286726544;262143;7773561;8035704;7249275;0.035197;quickSort
417400;143370196544;262143;7775361;8037504;7251075;0.035209;quickSort
417500;143453686544;262143;7777161;8039304;7252875;0.035242;quickSort
417600;143537196544;262143;7778961;8041104;7254675;0.035312;quickSort
417700;143620726544;262143;7780761;8042904;7256475;0.035249;quickSort
417800;143704276544;262143;7782561;8044704;7258275;0.035234;quickSort
417900;143787846544;262143;7784361;8046504;7260075;0.035308;quickSort
418000;143871436544;262143;7786161;8048304;7261875;0.035257;quickSort
418100;143955046544;262143;7787961;8050104;7263675;0.034546;quickSort
418200;1431038676544;262143;7789761;8051904;7265475;0.034376;quickSort
418300;1431122326544;262143;7791561;8053704;7267275;0.035357;quickSort
418400;1431205996544;262143;7793361;8055504;7269075;0.035293;quickSort
418500;144073934352;262143;7795161;8057304;7270875;0.035347;quickSort
418600;144157644352;262143;7796961;8059104;7272675;0.035268;quickSort
418700;144241374352;262143;7798761;8060904;7274475;0.035321;quickSort
418800;144325124352;262143;7800561;8062704;7276275;0.035402;quickSort
418900;144408894352;262143;7802361;8064504;7278075;0.035329;quickSort
419000;144492684352;262143;7804161;8066304;7279875;0.035429;quickSort
419100;144576494352;262143;7805961;8068104;7281675;0.035460;quickSort
419200;144660324352;262143;7807761;8069904;7283475;0.035319;quickSort
419300;144744174352;262143;7809561;8071704;7285275;0.035381;quickSort
419400;144828044352;262143;7811361;8073504;7287075;0.035404;quickSort
419500;144911934352;262143;7813161;8075304;7288875;0.035963;quickSort
419600;144995844352;262143;7814961;8077104;7290675;0.035398;quickSort
419700;1441079774352;262143;7816761;8078904;7292475;0.035373;quickSort
419800;1441163724352;262143;7818561;8080704;7294275;0.035441;quickSort
419900;145031942160;262143;7820361;8082504;7296075;0.035478;quickSort
420000;145115932160;262143;7822161;8084304;7297875;0.035373;quickSort
420100;145199942160;262143;7823961;8086104;7299675;0.035449;quickSort
420200;145283972160;262143;7825761;8087904;7301475;0.035371;quickSort
420300;145368022160;262143;7827561;8089704;7303275;0.036650;quickSort
420400;145452092160;262143;7829361;8091504;7305075;0.035510;quickSort
420500;145536182160;262143;7831161;8093304;7306875;0.036661;quickSort
420600;145620292160;262143;7832961;8095104;7308675;0.035491;quickSort
420700;145704422160;262143;7834761;8096904;7310475;0.035636;quickSort
420800;145788572160;262143;7836561;8098704;7312275;0.035411;quickSort
420900;145872742160;262143;7838361;8100504;7314075;0.035626;quickSort
421000;145956932160;262143;7840161;8102304;7315875;0.035531;quickSort
421100;1451041142160;262143;7841961;8104104;7317675;0.035581;quickSort
421200;1451125372160;262143;7843761;8105904;7319475;0.035472;quickSort
421300;1451209622160;262143;7845561;8107704;7321275;0.035555;quickSort
421400;146078139968;262143;7847361;8109504;7323075;0.035553;quickSort
421500;146162429968;262143;7849161;8111304;7324875;0.035540;quickSort
421600;146246739968;262143;7850961;8113104;7326675;0.035487;quickSort
421700;146331069968;262143;7852761;8114904;7328475;0.035549;quickSort
421800;146415419968;262143;7854561;8116704;7330275;0.035509;quickSort
421900;146499789968;262143;7856361;8118504;7332075;0.035492;quickSort
422000;146584179968;262143;7858161;8120304;7333875;0.035736;quickSort
422100;146668589968;262143;7859961;8122104;7335675;0.035541;quickSort
422200;146753019968;262143;7861761;8123904;7337475;0.035510;quickSort
422300;146837469968;262143;7863561;8125704;7339275;0.035537;quickSort
422400;146921939968;262143;7865361;8127504;7341075;0.035667;quickSort
422500;1461006429968;262143;7867161;8129304;7342875;0.035529;quickSort
422600;1461090939968;262143;7868961;8131104;7344675;0.035569;quickSort
422700;1461175469968;262143;7870761;8132904;7346475;0.035645;quickSort
422800;147044267776;262143;7872561;8134704;7348275;0.035608;quickSort
422900;147128837776;262143;7874361;8136504;7350075;0.035750;quickSort
423000;147213427776;262143;7876161;8138304;7351875;0.035625;quickSort
423100;147298037776;262143;7877961;8140104;7353675;0.035570;quickSort
423200;147382667776;262143;7879761;8141904;7355475;0.035659;quickSort
423300;147467317776;262143;7881561;8143704;7357275;0.035638;quickSort
423400;147551987776;262143;7883361;8145504;7359075;0.035668;quickSort
423500;147636677776;262143;7885161;8147304;7360875;0.035666;quickSort
423600;147721387776;262143;7886961;8149104;7362675;0.035669;quickSort
423700;147806117776;262143;7888761;8150904;7364475;0.035586;quickSort
423800;147890867776;262143;7890561;8152704;7366275;0.036076;quickSort
423900;147975637776;262143;7892361;8154504;7368075;0.036069;quickSort
424000;1471060427776;262143;7894161;8156304;7369875;0.035638;quickSort
424100;1471145237776;262143;7895961;8158104;7371675;0.035684;quickSort
424200;148014315584;262143;7897761;8159904;7373475;0.035692;quickSort
424300;148099165584;262143;7899561;8161704;7375275;0.035638;quickSort
424400;148184035584;262143;7901361;8163504;7377075;0.035679;quickSort
424500;148268925584;262143;7903161;8165304;7378875;0.035649;quickSort
424600;148353835584;262143;7904961;8167104;7380675;0.035689;quickSort
424700;148438765584;262143;7906761;8168904;7382475;0.035707;quickSort
424800;148523715584;262143;7908561;8170704;7384275;0.035753;quickSort
424900;148608685584;262143;7910361;8172504;7386075;0.035720;quickSort
425000;148693675584;262143;7912161;8174304;7387875;0.035757;quickSort
425100;148778685584;262143;7913961;8176104;7389675;0.037228;quickSort
425200;148863715584;262143;7915761;8177904;7391475;0.035736;quickSort
425300;148948765584;262143;7917561;8179704;7393275;0.035791;quickSort
425400;1481033835584;262143;7919361;8181504;7395075;0.035776;quickSort
425500;1481118925584;262143;7921161;8183304;7396875;0.035751;quickSort
425600;1481204035584;262143;7922961;8185104;7398675;0.037478;quickSort
425700;149073413392;262143;7924761;8186904;7400475;0.037628;quickSort
425800;149158563392;262143;7926561;8188704;7402275;0.035804;quickSort
425900;149243733392;262143;7928361;8190504;7404075;0.035735;quickSort
426000;149328923392;262143;7930161;8192304;7405875;0.035744;quickSort
426100;149414133392;262143;7931961;8194104;7407675;0.035754;quickSort
426200;149499363392;262143;7933761;8195904;7409475;0.035763;quickSort
426300;149584613392;262143;7935561;8197704;7411275;0.035740;quickSort
426400;149669883392;262143;7937361;8199504;7413075;0.035724;quickSort
426500;149755173392;262143;7939161;8201304;7414875;0.035723;quickSort
426600;149840483392;262143;7940961;8203104;7416675;0.035832;quickSort
426700;149925813392;262143;7942761;8204904;7418475;0.035907;quickSort
426800;1491011163392;262143;7944561;8206704;7420275;0.035802;quickSort
426900;1491096533392;262143;7946361;8208504;7422075;0.037858;quickSort
427000;1491181923392;262143;7948161;8210304;7423875;0.035741;quickSort
427100;150051581200;262143;7949961;8212104;7425675;0.036076;quickSort
427200;150137011200;262143;7951761;8213904;7427475;0.035858;quickSort
427300;150222461200;262143;7953561;8215704;7429275;0.036822;quickSort
427400;150307931200;262143;7955361;8217504;7431075;0.037028;quickSort
427500;150393421200;262143;7957161;8219304;7432875;0.035856;quickSort
427600;150478931200;262143;7958961;8221104;7434675;0.035846;quickSort
427700;150564461200;262143;7960761;8222904;7436475;0.035840;quickSort
427800;150650011200;262143;7962561;8224704;7438275;0.036457;quickSort
427900;150735581200;262143;7964361;8226504;7440075;0.036628;quickSort
428000;150821171200;262143;7966161;8228304;7441875;0.036290;quickSort
428100;150906781200;262143;7967961;8230104;7443675;0.037303;quickSort
428200;150992411200;262143;7969761;8231904;7445475;0.036325;quickSort
428300;1501078061200;262143;7971561;8233704;7447275;0.036342;quickSort
428400;1501163731200;262143;7973361;8235504;7449075;0.036370;quickSort
428500;151033669008;262143;7975161;8237304;7450875;0.035981;quickSort
428600;151119379008;262143;7976961;8239104;7452675;0.035987;quickSort
428700;151205109008;262143;7978761;8240904;7454475;0.035943;quickSort
428800;151290859008;262143;7980561;8242704;7456275;0.036115;quickSort
428900;151376629008;262143;7982361;8244504;7458075;0.036018;quickSort
429000;151462419008;262143;7984161;8246304;7459875;0.036117;quickSort
429100;151548229008;262143;7985961;8248104;7461675;0.035996;quickSort
429200;151634059008;262143;7987761;8249904;7463475;0.036408;quickSort
429300;151719909008;262143;7989561;8251704;7465275;0.037003;quickSort
429400;151805779008;262143;7991361;8253504;7467075;0.037436;quickSort
429500;151891669008;262143;7993161;8255304;7468875;0.036065;quickSort
429600;151977579008;262143;7994961;8257104;7470675;0.036020;quickSort
429700;1511063509008;262143;7996761;8258904;7472475;0.036415;quickSort
429800;1511149459008;262143;7998561;8260704;7474275;0.036034;quickSort
429900;152019676816;262143;8000361;8262504;7476075;0.036211;quickSort
430000;152105666816;262143;8002161;8264304;7477875;0.036333;quickSort
430100;152191676816;262143;8003961;8266104;7479675;0.036777;quickSort
430200;152277706816;262143;8005761;8267904;7481475;0.036073;quickSort
430300;152363756816;262143;8007561;8269704;7483275;0.036057;quickSort
430400;152449826816;262143;8009361;8271504;7485075;0.036127;quickSort
430500;152535916816;262143;8011161;8273304;7486875;0.036066;quickSort
430600;152622026816;262143;8012961;8275104;7488675;0.036003;quickSort
430700;152708156816;262143;8014761;8276904;7490475;0.036678;quickSort
430800;152794306816;262143;8016561;8278704;7492275;0.036180;quickSort
430900;152880476816;262143;8018361;8280504;7494075;0.036133;quickSort
431000;152966666816;262143;8020161;8282304;7495875;0.036114;quickSort
431100;1521052876816;262143;8021961;8284104;7497675;0.036118;quickSort
431200;1521139106816;262143;8023761;8285904;7499475;0.036088;quickSort
431300;153009604624;262143;8025561;8287704;7501275;0.036140;quickSort
431400;153095874624;262143;8027361;8289504;7503075;0.036545;quickSort
431500;153182164624;262143;8029161;8291304;7504875;0.036373;quickSort
431600;153268474624;262143;8030961;8293104;7506675;0.035278;quickSort
431700;153354804624;262143;8032761;8294904;7508475;0.035750;quickSort
431800;153441154624;262143;8034561;8296704;7510275;0.036114;quickSort
431900;153527524624;262143;8036361;8298504;7512075;0.036177;quickSort
432000;153613914624;262143;8038161;8300304;7513875;0.036234;quickSort
432100;153700324624;262143;8039961;8302104;7515675;0.036193;quickSort
432200;153786754624;262143;8041761;8303904;7517475;0.036380;quickSort
432300;153873204624;262143;8043561;8305704;7519275;0.036126;quickSort
432400;153959674624;262143;8045361;8307504;7521075;0.036171;quickSort
432500;1531046164624;262143;8047161;8309304;7522875;0.037424;quickSort
432600;1531132674624;262143;8048961;8311104;7524675;0.036165;quickSort
432700;154003452432;262143;8050761;8312904;7526475;0.036164;quickSort
432800;154090002432;262143;8052561;8314704;7528275;0.036297;quickSort
432900;154176572432;262143;8054361;8316504;7530075;0.036201;quickSort
433000;154263162432;262143;8056161;8318304;7531875;0.036286;quickSort
433100;154349772432;262143;8057961;8320104;7533675;0.036245;quickSort
433200;154436402432;262143;8059761;8321904;7535475;0.036346;quickSort
433300;154523052432;262143;8061561;8323704;7537275;0.036249;quickSort
433400;154609722432;262143;8063361;8325504;7539075;0.036265;quickSort
433500;154696412432;262143;8065161;8327304;7540875;0.036316;quickSort
433600;154783122432;262143;8066961;8329104;7542675;0.036257;quickSort
433700;154869852432;262143;8068761;8330904;7544475;0.036266;quickSort
433800;154956602432;262143;8070561;8332704;7546275;0.036347;quickSort
433900;1541043372432;262143;8072361;8334504;7548075;0.036298;quickSort
434000;1541130162432;262143;8074161;8336304;7549875;0.036336;quickSort
434100;155001220240;262143;8075961;8338104;7551675;0.036302;quickSort
434200;155088050240;262143;8077761;8339904;7553475;0.036337;quickSort
434300;155174900240;262143;8079561;8341704;7555275;0.036308;quickSort
434400;155261770240;262143;8081361;8343504;7557075;0.036408;quickSort
434500;155348660240;262143;8083161;8345304;7558875;0.036285;quickSort
434600;155435570240;262143;8084961;8347104;7560675;0.036921;quickSort
434700;155522500240;262143;8086761;8348904;7562475;0.036383;quickSort
434800;155609450240;262143;8088561;8350704;7564275;0.039307;quickSort
434900;155696420240;262143;8090361;8352504;7566075;0.036397;quickSort
435000;155783410240;262143;8092161;8354304;7567875;0.036772;quickSort
435100;155870420240;262143;8093961;8356104;7569675;0.037651;quickSort
435200;155957450240;262143;8095761;8357904;7571475;0.040861;quickSort
435300;1551044500240;262143;8097561;8359704;7573275;0.037934;quickSort
435400;1551131570240;262143;8099361;8361504;7575075;0.036597;quickSort
435500;156002908048;262143;8101161;8363304;7576875;0.036410;quickSort
435600;156090018048;262143;8102961;8365104;7578675;0.036444;quickSort
435700;156177148048;262143;8104761;8366904;7580475;0.036410;quickSort
435800;156264298048;262143;8106561;8368704;7582275;0.036494;quickSort
435900;156351468048;262143;8108361;8370504;7584075;0.036585;quickSort
436000;156438658048;262143;8110161;8372304;7585875;0.037771;quickSort
436100;156525868048;262143;8111961;8374104;7587675;0.036517;quickSort
436200;156613098048;262143;8113761;8375904;7589475;0.036401;quickSort
436300;156700348048;262143;8115561;8377704;7591275;0.036428;quickSort
436400;156787618048;262143;8117361;8379504;7593075;0.036387;quickSort
436500;156874908048;262143;8119161;8381304;7594875;0.036408;quickSort
436600;156962218048;262143;8120961;8383104;7596675;0.036426;quickSort
436700;1561049548048;262143;8122761;8384904;7598475;0.036450;quickSort
436800;1561136898048;262143;8124561;8386704;7600275;0.036388;quickSort
436900;157008515856;262143;8126361;8388504;7602075;0.036470;quickSort
437000;157095905856;262143;8128161;8390304;7603875;0.036450;quickSort
437100;157183315856;262143;8129961;8392104;7605675;0.036476;quickSort
437200;157270745856;262143;8131761;8393904;7607475;0.036517;quickSort
437300;157358195856;262143;8133561;8395704;7609275;0.036702;quickSort
437400;157445665856;262143;8135361;8397504;7611075;0.036520;quickSort
437500;157533155856;262143;8137161;8399304;7612875;0.036528;quickSort
437600;157620665856;262143;8138961;8401104;7614675;0.036497;quickSort
437700;157708195856;262143;8140761;8402904;7616475;0.036553;quickSort
437800;157795745856;262143;8142561;8404704;7618275;0.036531;quickSort
437900;157883315856;262143;8144361;8406504;7620075;0.036460;quickSort
438000;157970905856;262143;8146161;8408304;7621875;0.036557;quickSort
438100;1571058515856;262143;8147961;8410104;7623675;0.036592;quickSort
438200;1571146145856;262143;8149761;8411904;7625475;0.036604;quickSort
438300;158018043664;262143;8151561;8413704;7627275;0.036580;quickSort
438400;158105713664;262143;8153361;8415504;7629075;0.036664;quickSort
438500;158193403664;262143;8155161;8417304;7630875;0.036972;quickSort
438600;158281113664;262143;8156961;8419104;7632675;0.036320;quickSort
438700;158368843664;262143;8158761;8420904;7634475;0.036620;quickSort
438800;158456593664;262143;8160561;8422704;7636275;0.036577;quickSort
438900;158544363664;262143;8162361;8424504;7638075;0.036655;quickSort
439000;158632153664;262143;8164161;8426304;7639875;0.036602;quickSort
439100;158719963664;262143;8165961;8428104;7641675;0.036650;quickSort
439200;158807793664;262143;8167761;8429904;7643475;0.036609;quickSort
439300;158895643664;262143;8169561;8431704;7645275;0.036621;quickSort
439400;158983513664;262143;8171361;8433504;7647075;0.036606;quickSort
439500;1581071403664;262143;8173161;8435304;7648875;0.036658;quickSort
439600;1581159313664;262143;8174961;8437104;7650675;0.036657;quickSort
439700;159031491472;262143;8176761;8438904;7652475;0.037116;quickSort
439800;159119441472;262143;8178561;8440704;7654275;0.036698;quickSort
439900;159207411472;262143;8180361;8442504;7656075;0.036662;quickSort
440000;159295401472;262143;8182161;8444304;7657875;0.036653;quickSort
440100;159383411472;262143;8183961;8446104;7659675;0.036654;quickSort
440200;159471441472;262143;8185761;8447904;7661475;0.036715;quickSort
440300;159559491472;262143;8187561;8449704;7663275;0.036744;quickSort
440400;159647561472;262143;8189361;8451504;7665075;0.036871;quickSort
440500;159735651472;262143;8191161;8453304;7666875;0.036760;quickSort
440600;159823761472;262143;8192961;8455104;7668675;0.037863;quickSort
440700;159911891472;262143;8194761;8456904;7670475;0.036713;quickSort
440800;1591000041472;262143;8196561;8458704;7672275;0.036744;quickSort
440900;1591088211472;262143;8198361;8460504;7674075;0.036744;quickSort
441000;1591176401472;262143;8200161;8462304;7675875;0.036924;quickSort
441100;160048859280;262143;8201961;8464104;7677675;0.037493;quickSort
441200;160137089280;262143;8203761;8465904;7679475;0.036996;quickSort
441300;160225339280;262143;8205561;8467704;7681275;0.036724;quickSort
441400;160313609280;262143;8207361;8469504;7683075;0.036780;quickSort
441500;160401899280;262143;8209161;8471304;7684875;0.036758;quickSort
441600;160490209280;262143;8210961;8473104;7686675;0.036818;quickSort
441700;160578539280;262143;8212761;8474904;7688475;0.036792;quickSort
441800;160666889280;262143;8214561;8476704;7690275;0.036820;quickSort
441900;160755259280;262143;8216361;8478504;7692075;0.036889;quickSort
442000;160843649280;262143;8218161;8480304;7693875;0.037837;quickSort
442100;160932059280;262143;8219961;8482104;7695675;0.036766;quickSort
442200;1601020489280;262143;8221761;8483904;7697475;0.036788;quickSort
442300;1601108939280;262143;8223561;8485704;7699275;0.036839;quickSort
442400;1601197409280;262143;8225361;8487504;7701075;0.036795;quickSort
442500;161070147088;262143;8227161;8489304;7702875;0.036821;quickSort
442600;161158657088;262143;8228961;8491104;7704675;0.036838;quickSort
442700;161247187088;262143;8230761;8492904;7706475;0.036797;quickSort
442800;161335737088;262143;8232561;8494704;7708275;0.036859;quickSort
442900;161424307088;262143;8234361;8496504;7710075;0.036950;quickSort
443000;161512897088;262143;8236161;8498304;7711875;0.036852;quickSort
443100;161601507088;262143;8237961;8500104;7713675;0.036892;quickSort
443200;161690137088;262143;8239761;8501904;7715475;0.036881;quickSort
443300;161778787088;262143;8241561;8503704;7717275;0.036889;quickSort
443400;161867457088;262143;8243361;8505504;7719075;0.037102;quickSort
443500;161956147088;262143;8245161;8507304;7720875;0.037033;quickSort
443600;1611044857088;262143;8246961;8509104;7722675;0.036291;quickSort
443700;1611133587088;262143;8248761;8510904;7724475;0.036956;quickSort
443800;162006584896;262143;8250561;8512704;7726275;0.037183;quickSort
443900;162095354896;262143;8252361;8514504;7728075;0.037048;quickSort
444000;162184144896;262143;8254161;8516304;7729875;0.037509;quickSort
444100;162272954896;262143;8255961;8518104;7731675;0.037434;quickSort
444200;162361784896;262143;8257761;8519904;7733475;0.037554;quickSort
444300;162450634896;262143;8259561;8521704;7735275;0.037131;quickSort
444400;162539504896;262143;8261361;8523504;7737075;0.037013;quickSort
444500;162628394896;262143;8263161;8525304;7738875;0.036935;quickSort
444600;162717304896;262143;8264961;8527104;7740675;0.036972;quickSort
444700;162806234896;262143;8266761;8528904;7742475;0.036927;quickSort
444800;162895184896;262143;8268561;8530704;7744275;0.037541;quickSort
444900;162984154896;262143;8270361;8532504;7746075;0.037036;quickSort
445000;1621073144896;262143;8272161;8534304;7747875;0.036978;quickSort
445100;1621162154896;262143;8273961;8536104;7749675;0.036959;quickSort
445200;163035432704;262143;8275761;8537904;7751475;0.037900;quickSort
445300;163124482704;262143;8277561;8539704;7753275;0.036964;quickSort
445400;163213552704;262143;8279361;8541504;7755075;0.037010;quickSort
445500;163302642704;262143;8281161;8543304;7756875;0.037086;quickSort
445600;163391752704;262143;8282961;8545104;7758675;0.036950;quickSort
445700;163480882704;262143;8284761;8546904;7760475;0.036991;quickSort
445800;163570032704;262143;8286561;8548704;7762275;0.037076;quickSort
445900;163659202704;262143;8288361;8550504;7764075;0.037045;quickSort
446000;163748392704;262143;8290161;8552304;7765875;0.037085;quickSort
446100;163837602704;262143;8291961;8554104;7767675;0.036994;quickSort
446200;163926832704;262143;8293761;8555904;7769475;0.038429;quickSort
446300;1631016082704;262143;8295561;8557704;7771275;0.036990;quickSort
446400;1631105352704;262143;8297361;8559504;7773075;0.037005;quickSort
446500;1631194642704;262143;8299161;8561304;7774875;0.037014;quickSort
446600;164068200512;262143;8300961;8563104;7776675;0.037071;quickSort
446700;164157530512;262143;8302761;8564904;7778475;0.037029;quickSort
446800;164246880512;262143;8304561;8566704;7780275;0.036978;quickSort
446900;164336250512;262143;8306361;8568504;7782075;0.037060;quickSort
447000;164425640512;262143;8308161;8570304;7783875;0.037084;quickSort
447100;164515050512;262143;8309961;8572104;7785675;0.037041;quickSort
447200;164604480512;262143;8311761;8573904;7787475;0.037049;quickSort
447300;164693930512;262143;8313561;8575704;7789275;0.037052;quickSort
447400;164783400512;262143;8315361;8577504;7791075;0.037094;quickSort
447500;164872890512;262143;8317161;8579304;7792875;0.037083;quickSort
447600;164962400512;262143;8318961;8581104;7794675;0.037045;quickSort
447700;1641051930512;262143;8320761;8582904;7796475;0.037268;quickSort
447800;1641141480512;262143;8322561;8584704;7798275;0.037146;quickSort
447900;165015298320;262143;8324361;8586504;7800075;0.037090;quickSort
448000;165104888320;262143;8326161;8588304;7801875;0.037151;quickSort
448100;165194498320;262143;8327961;8590104;7803675;0.037245;quickSort
448200;165284128320;262143;8329761;8591904;7805475;0.039179;quickSort
448300;165373778320;262143;8331561;8593704;7807275;0.038098;quickSort
448400;165463448320;262143;8333361;8595504;7809075;0.037113;quickSort
448500;165553138320;262143;8335161;8597304;7810875;0.037156;quickSort
448600;165642848320;262143;8336961;8599104;7812675;0.037172;quickSort
448700;165732578320;262143;8338761;8600904;7814475;0.037199;quickSort
448800;165822328320;262143;8340561;8602704;7816275;0.037155;quickSort
448900;165912098320;262143;8342361;8604504;7818075;0.037349;quickSort
449000;1651001888320;262143;8344161;8606304;7819875;0.037161;quickSort
449100;1651091698320;262143;8345961;8608104;7821675;0.037345;quickSort
449200;1651181528320;262143;8347761;8609904;7823475;0.037155;quickSort
449300;166055626128;262143;8349561;8611704;7825275;0.037396;quickSort
449400;166145496128;262143;8351361;8613504;7827075;0.037181;quickSort
449500;166235386128;262143;8353161;8615304;7828875;0.037107;quickSort
449600;166325296128;262143;8354961;8617104;7830675;0.037149;quickSort
449700;166415226128;262143;8356761;8618904;7832475;0.037186;quickSort
449800;166505176128;262143;8358561;8620704;7834275;0.037172;quickSort
449900;166595146128;262143;8360361;8622504;7836075;0.037223;quickSort
450000;166685136128;262143;8362161;8624304;7837875;0.037209;quickSort
450100;166775146128;262143;8363961;8626104;7839675;0.037206;quickSort
450200;166865176128;262143;8365761;8627904;7841475;0.037177;quickSort
450300;166955226128;262143;8367561;8629704;7843275;0.037193;quickSort
450400;1661045296128;262143;8369361;8631504;7845075;0.037195;quickSort
450500;1661135386128;262143;8371161;8633304;7846875;0.037355;quickSort
450600;167009743936;262143;8372961;8635104;7848675;0.037353;quickSort
450700;167099873936;262143;8374761;8636904;7850475;0.037326;quickSort
450800;167190023936;262143;8376561;8638704;7852275;0.037256;quickSort
450900;167280193936;262143;8378361;8640504;7854075;0.037247;quickSort
451000;167370383936;262143;8380161;8642304;7855875;0.037306;quickSort
451100;167460593936;262143;8381961;8644104;7857675;0.037284;quickSort
451200;167550823936;262143;8383761;8645904;7859475;0.037316;quickSort
451300;167641073936;262143;8385561;8647704;7861275;0.037570;quickSort
451400;167731343936;262143;8387361;8649504;7863075;0.037259;quickSort
451500;167821633936;262143;8389161;8651304;7864875;0.037462;quickSort
451600;167911943936;262143;8390961;8653104;7866675;0.037334;quickSort
451700;1671002273936;262143;8392761;8654904;7868475;0.037314;quickSort
451800;1671092623936;262143;8394561;8656704;7870275;0.037243;quickSort
451900;1671182993936;262143;8396361;8658504;7872075;0.037318;quickSort
452000;168057631744;262143;8398161;8660304;7873875;0.037340;quickSort
452100;168148041744;262143;8399961;8662104;7875675;0.039771;quickSort
452200;168238471744;262143;8401761;8663904;7877475;0.037335;quickSort
452300;168328921744;262143;8403561;8665704;7879275;0.037359;quickSort
452400;168419391744;262143;8405361;8667504;7881075;0.037350;quickSort
452500;168509881744;262143;8407161;8669304;7882875;0.037310;quickSort
452600;168600391744;262143;8408961;8671104;7884675;0.037244;quickSort
452700;168690921744;262143;8410761;8672904;7886475;0.037325;quickSort
452800;168781471744;262143;8412561;8674704;7888275;0.037409;quickSort
452900;168872041744;262143;8414361;8676504;7890075;0.037433;quickSort
453000;168962631744;262143;8416161;8678304;7891875;0.037414;quickSort
453100;1681053241744;262143;8417961;8680104;7893675;0.037406;quickSort
453200;1681143871744;262143;8419761;8681904;7895475;0.037337;quickSort
453300;169018769552;262143;8421561;8683704;7897275;0.037391;quickSort
453400;169109439552;262143;8423361;8685504;7899075;0.037415;quickSort
453500;169200129552;262143;8425161;8687304;7900875;0.037425;quickSort
453600;169290839552;262143;8426961;8689104;7902675;0.037335;quickSort
453700;169381569552;262143;8428761;8690904;7904475;0.037388;quickSort
453800;169472319552;262143;8430561;8692704;7906275;0.037553;quickSort
453900;169563089552;262143;8432361;8694504;7908075;0.037442;quickSort
454000;169653879552;262143;8434161;8696304;7909875;0.037436;quickSort
454100;169744689552;262143;8435961;8698104;7911675;0.037362;quickSort
454200;169835519552;262143;8437761;8699904;7913475;0.037378;quickSort
454300;169926369552;262143;8439561;8701704;7915275;0.037471;quickSort
454400;1691017239552;262143;8441361;8703504;7917075;0.037455;quickSort
454500;1691108129552;262143;8443161;8705304;7918875;0.037432;quickSort
454600;1691199039552;262143;8444961;8707104;7920675;0.037637;quickSort
454700;170074217360;262143;8446761;8708904;7922475;0.037472;quickSort
454800;170165167360;262143;8448561;8710704;7924275;0.037460;quickSort
454900;170256137360;262143;8450361;8712504;7926075;0.037530;quickSort
455000;170347127360;262143;8452161;8714304;7927875;0.037371;quickSort
455100;170438137360;262143;8453961;8716104;7929675;0.037589;quickSort
455200;170529167360;262143;8455761;8717904;7931475;0.037404;quickSort
455300;170620217360;262143;8457561;8719704;7933275;0.037523;quickSort
455400;170711287360;262143;8459361;8721504;7935075;0.037671;quickSort
455500;170802377360;262143;8461161;8723304;7936875;0.037418;quickSort
455600;170893487360;262143;8462961;8725104;7938675;0.037440;quickSort
455700;170984617360;262143;8464761;8726904;7940475;0.037452;quickSort
455800;1701075767360;262143;8466561;8728704;7942275;0.037489;quickSort
455900;1701166937360;262143;8468361;8730504;7944075;0.037443;quickSort
456000;171042375168;262143;8470161;8732304;7945875;0.037516;quickSort
456100;171133585168;262143;8471961;8734104;7947675;0.037547;quickSort
456200;171224815168;262143;8473761;8735904;7949475;0.037494;quickSort
456300;171316065168;262143;8475561;8737704;7951275;0.037663;quickSort
456400;171407335168;262143;8477361;8739504;7953075;0.036551;quickSort
456500;171498625168;262143;8479161;8741304;7954875;0.037259;quickSort
456600;171589935168;262143;8480961;8743104;7956675;0.037534;quickSort
456700;171681265168;262143;8482761;8744904;7958475;0.037456;quickSort
456800;171772615168;262143;8484561;8746704;7960275;0.037636;quickSort
456900;171863985168;262143;8486361;8748504;7962075;0.037597;quickSort
457000;171955375168;262143;8488161;8750304;7963875;0.037634;quickSort
457100;1711046785168;262143;8489961;8752104;7965675;0.037510;quickSort
457200;1711138215168;262143;8491761;8753904;7967475;0.038882;quickSort
457300;172013912976;262143;8493561;8755704;7969275;0.037525;quickSort
457400;172105382976;262143;8495361;8757504;7971075;0.037563;quickSort
457500;172196872976;262143;8497161;8759304;7972875;0.037668;quickSort
457600;172288382976;262143;8498961;8761104;7974675;0.037522;quickSort
457700;172379912976;262143;8500761;8762904;7976475;0.037635;quickSort
457800;172471462976;262143;8502561;8764704;7978275;0.037268;quickSort
457900;172563032976;262143;8504361;8766504;7980075;0.036619;quickSort
458000;172654622976;262143;8506161;8768304;7981875;0.037491;quickSort
458100;172746232976;262143;8507961;8770104;7983675;0.037611;quickSort
458200;172837862976;262143;8509761;8771904;7985475;0.037548;quickSort
458300;172929512976;262143;8511561;8773704;7987275;0.037528;quickSort
458400;1721021182976;262143;8513361;8775504;7989075;0.037596;quickSort
458500;1721112872976;262143;8515161;8777304;7990875;0.037524;quickSort
458600;1721204582976;262143;8516961;8779104;7992675;0.037565;quickSort
458700;173080560784;262143;8518761;8780904;7994475;0.037613;quickSort
458800;173172310784;262143;8520561;8782704;7996275;0.037650;quickSort
458900;173264080784;262143;8522361;8784504;7998075;0.037636;quickSort
459000;173355870784;262143;8524161;8786304;7999875;0.037590;quickSort
459100;173447680784;262143;8525961;8788104;8001675;0.037636;quickSort
459200;173539510784;262143;8527761;8789904;8003475;0.037573;quickSort
459300;173631360784;262143;8529561;8791704;8005275;0.037598;quickSort
459400;173723230784;262143;8531361;8793504;8007075;0.037665;quickSort
459500;173815120784;262143;8533161;8795304;8008875;0.037598;quickSort
459600;173907030784;262143;8534961;8797104;8010675;0.037627;quickSort
459700;173998960784;262143;8536761;8798904;8012475;0.037646;quickSort
459800;1731090910784;262143;8538561;8800704;8014275;0.037623;quickSort
459900;1731182880784;262143;8540361;8802504;8016075;0.037781;quickSort
460000;174059118592;262143;8542161;8804304;8017875;0.037734;quickSort
460100;174151128592;262143;8543961;8806104;8019675;0.037678;quickSort
460200;174243158592;262143;8545761;8807904;8021475;0.037713;quickSort
460300;174335208592;262143;8547561;8809704;8023275;0.037777;quickSort
460400;174427278592;262143;8549361;8811504;8025075;0.037896;quickSort
460500;174519368592;262143;8551161;8813304;8026875;0.038091;quickSort
460600;174611478592;262143;8552961;8815104;8028675;0.037760;quickSort
460700;174703608592;262143;8554761;8816904;8030475;0.038968;quickSort
460800;174795758592;262143;8556561;8818704;8032275;0.037693;quickSort
460900;174887928592;262143;8558361;8820504;8034075;0.037765;quickSort
461000;174980118592;262143;8560161;8822304;8035875;0.037791;quickSort
461100;1741072328592;262143;8561961;8824104;8037675;0.037788;quickSort
461200;1741164558592;262143;8563761;8825904;8039475;0.037764;quickSort
461300;175041056400;262143;8565561;8827704;8041275;0.039166;quickSort
461400;175133326400;262143;8567361;8829504;8043075;0.039673;quickSort
461500;175225616400;262143;8569161;8831304;8044875;0.037822;quickSort
461600;175317926400;262143;8570961;8833104;8046675;0.037814;quickSort
461700;175410256400;262143;8572761;8834904;8048475;0.037937;quickSort
461800;175502606400;262143;8574561;8836704;8050275;0.037784;quickSort
461900;175594976400;262143;8576361;8838504;8052075;0.037885;quickSort
462000;175687366400;262143;8578161;8840304;8053875;0.037963;quickSort
462100;175779776400;262143;8579961;8842104;8055675;0.037858;quickSort
462200;175872206400;262143;8581761;8843904;8057475;0.037859;quickSort
462300;175964656400;262143;8583561;8845704;8059275;0.037830;quickSort
462400;1751057126400;262143;8585361;8847504;8061075;0.037924;quickSort
462500;1751149616400;262143;8587161;8849304;8062875;0.037929;quickSort
462600;176026374208;262143;8588961;8851104;8064675;0.037908;quickSort
462700;176118904208;262143;8590761;8852904;8066475;0.037866;quickSort
462800;176211454208;262143;8592561;8854704;8068275;0.037879;quickSort
462900;176304024208;262143;8594361;8856504;8070075;0.037996;quickSort
463000;176396614208;262143;8596161;8858304;8071875;0.037985;quickSort
463100;176489224208;262143;8597961;8860104;8073675;0.037896;quickSort
463200;176581854208;262143;8599761;8861904;8075475;0.038005;quickSort
463300;176674504208;262143;8601561;8863704;8077275;0.038028;quickSort
463400;176767174208;262143;8603361;8865504;8079075;0.038105;quickSort
463500;176859864208;262143;8605161;8867304;8080875;0.038098;quickSort
463600;176952574208;262143;8606961;8869104;8082675;0.038230;quickSort
463700;1761045304208;262143;8608761;8870904;8084475;0.038018;quickSort
463800;1761138054208;262143;8610561;8872704;8086275;0.038112;quickSort
463900;177015072016;262143;8612361;8874504;8088075;0.038472;quickSort
464000;177107862016;262143;8614161;8876304;8089875;0.038181;quickSort
464100;177200672016;262143;8615961;8878104;8091675;0.038020;quickSort
464200;177293502016;262143;8617761;8879904;8093475;0.038023;quickSort
464300;177386352016;262143;8619561;8881704;8095275;0.037977;quickSort
464400;177479222016;262143;8621361;8883504;8097075;0.037952;quickSort
464500;177572112016;262143;8623161;8885304;8098875;0.038009;quickSort
464600;177665022016;262143;8624961;8887104;8100675;0.038118;quickSort
464700;177757952016;262143;8626761;8888904;8102475;0.038740;quickSort
464800;177850902016;262143;8628561;8890704;8104275;0.038095;quickSort
464900;177943872016;262143;8630361;8892504;8106075;0.038098;quickSort
465000;1771036862016;262143;8632161;8894304;8107875;0.038102;quickSort
465100;1771129872016;262143;8633961;8896104;8109675;0.038010;quickSort
465200;178007149824;262143;8635761;8897904;8111475;0.038101;quickSort
465300;178100199824;262143;8637561;8899704;8113275;0.038071;quickSort
465400;178193269824;262143;8639361;8901504;8115075;0.038100;quickSort
465500;178286359824;262143;8641161;8903304;8116875;0.038098;quickSort
465600;178379469824;262143;8642961;8905104;8118675;0.038169;quickSort
465700;178472599824;262143;8644761;8906904;8120475;0.038277;quickSort
465800;178565749824;262143;8646561;8908704;8122275;0.038090;quickSort
465900;178658919824;262143;8648361;8910504;8124075;0.038108;quickSort
466000;178752109824;262143;8650161;8912304;8125875;0.038151;quickSort
466100;178845319824;262143;8651961;8914104;8127675;0.038092;quickSort
466200;178938549824;262143;8653761;8915904;8129475;0.038166;quickSort
466300;1781031799824;262143;8655561;8917704;8131275;0.039395;quickSort
466400;1781125069824;262143;8657361;8919504;8133075;0.038357;quickSort
466500;179002607632;262143;8659161;8921304;8134875;0.038301;quickSort
466600;179095917632;262143;8660961;8923104;8136675;0.038285;quickSort
466700;179189247632;262143;8662761;8924904;8138475;0.038108;quickSort
466800;179282597632;262143;8664561;8926704;8140275;0.038212;quickSort
466900;179375967632;262143;8666361;8928504;8142075;0.038219;quickSort
467000;179469357632;262143;8668161;8930304;8143875;0.039496;quickSort
467100;179562767632;262143;8669961;8932104;8145675;0.038227;quickSort
467200;179656197632;262143;8671761;8933904;8147475;0.038263;quickSort
467300;179749647632;262143;8673561;8935704;8149275;0.038176;quickSort
467400;179843117632;262143;8675361;8937504;8151075;0.038278;quickSort
467500;179936607632;262143;8677161;8939304;8152875;0.038281;quickSort
467600;1791030117632;262143;8678961;8941104;8154675;0.038226;quickSort
467700;1791123647632;262143;8680761;8942904;8156475;0.038296;quickSort
467800;180001445440;262143;8682561;8944704;8158275;0.038247;quickSort
467900;180095015440;262143;8684361;8946504;8160075;0.038258;quickSort
468000;180188605440;262143;8686161;8948304;8161875;0.038363;quickSort
468100;180282215440;262143;8687961;8950104;8163675;0.038272;quickSort
468200;180375845440;262143;8689761;8951904;8165475;0.038344;quickSort
468300;180469495440;262143;8691561;8953704;8167275;0.038268;quickSort
468400;180563165440;262143;8693361;8955504;8169075;0.038310;quickSort
468500;180656855440;262143;8695161;8957304;8170875;0.038705;quickSort
468600;180750565440;262143;8696961;8959104;8172675;0.038495;quickSort
468700;180844295440;262143;8698761;8960904;8174475;0.038334;quickSort
468800;180938045440;262143;8700561;8962704;8176275;0.038334;quickSort
468900;1801031815440;262143;8702361;8964504;8178075;0.038500;quickSort
469000;1801125605440;262143;8704161;8966304;8179875;0.037461;quickSort
469100;181003663248;262143;8705961;8968104;8181675;0.037810;quickSort
469200;181097493248;262143;8707761;8969904;8183475;0.038331;quickSort
469300;181191343248;262143;8709561;8971704;8185275;0.038373;quickSort
469400;181285213248;262143;8711361;8973504;8187075;0.038346;quickSort
469500;181379103248;262143;8713161;8975304;8188875;0.038677;quickSort
469600;181473013248;262143;8714961;8977104;8190675;0.039917;quickSort
469700;181566943248;262143;8716761;8978904;8192475;0.038398;quickSort
469800;181660893248;262143;8718561;8980704;8194275;0.038343;quickSort
469900;181754863248;262143;8720361;8982504;8196075;0.038441;quickSort
470000;181848853248;262143;8722161;8984304;8197875;0.038440;quickSort
470100;181942863248;262143;8723961;8986104;8199675;0.039521;quickSort
470200;1811036893248;262143;8725761;8987904;8201475;0.038522;quickSort
470300;1811130943248;262143;8727561;8989704;8203275;0.038443;quickSort
470400;182009261056;262143;8729361;8991504;8205075;0.038367;quickSort
470500;182103351056;262143;8731161;8993304;8206875;0.038391;quickSort
470600;182197461056;262143;8732961;8995104;8208675;0.038499;quickSort
470700;182291591056;262143;8734761;8996904;8210475;0.038520;quickSort
470800;182385741056;262143;8736561;8998704;8212275;0.039901;quickSort
470900;182479911056;262143;8738361;9000504;8214075;0.039545;quickSort
471000;182574101056;262143;8740161;9002304;8215875;0.038618;quickSort
471100;182668311056;262143;8741961;9004104;8217675;0.039155;quickSort
471200;182762541056;262143;8743761;9005904;8219475;0.039757;quickSort
471300;182856791056;262143;8745561;9007704;8221275;0.038561;quickSort
471400;182951061056;262143;8747361;9009504;8223075;0.038531;quickSort
471500;1821045351056;262143;8749161;9011304;8224875;0.038530;quickSort
471600;1821139661056;262143;8750961;9013104;8226675;0.038539;quickSort
471700;183018238864;262143;8752761;9014904;8228475;0.038558;quickSort
471800;183112588864;262143;8754561;9016704;8230275;0.038532;quickSort
471900;183206958864;262143;8756361;9018504;8232075;0.038738;quickSort
472000;183301348864;262143;8758161;9020304;8233875;0.038529;quickSort
472100;183395758864;262143;8759961;9022104;8235675;0.038581;quickSort
472200;183490188864;262143;8761761;9023904;8237475;0.038552;quickSort
472300;183584638864;262143;8763561;9025704;8239275;0.038537;quickSort
472400;183679108864;262143;8765361;9027504;8241075;0.038582;quickSort
472500;183773598864;262143;8767161;9029304;8242875;0.038724;quickSort
472600;183868108864;262143;8768961;9031104;8244675;0.039036;quickSort
472700;183962638864;262143;8770761;9032904;8246475;0.038599;quickSort
472800;1831057188864;262143;8772561;9034704;8248275;0.038614;quickSort
472900;1831151758864;262143;8774361;9036504;8250075;0.038744;quickSort
473000;184030596672;262143;8776161;9038304;8251875;0.038598;quickSort
473100;184125206672;262143;8777961;9040104;8253675;0.038664;quickSort
473200;184219836672;262143;8779761;9041904;8255475;0.040279;quickSort
473300;184314486672;262143;8781561;9043704;8257275;0.038748;quickSort
473400;184409156672;262143;8783361;9045504;8259075;0.038890;quickSort
473500;184503846672;262143;8785161;9047304;8260875;0.038728;quickSort
473600;184598556672;262143;8786961;9049104;8262675;0.038682;quickSort
473700;184693286672;262143;8788761;9050904;8264475;0.038723;quickSort
473800;184788036672;262143;8790561;9052704;8266275;0.038718;quickSort
473900;184882806672;262143;8792361;9054504;8268075;0.039037;quickSort
474000;184977596672;262143;8794161;9056304;8269875;0.039762;quickSort
474100;1841072406672;262143;8795961;9058104;8271675;0.040764;quickSort
474200;1841167236672;262143;8797761;9059904;8273475;0.039517;quickSort
474300;185046334480;262143;8799561;9061704;8275275;0.039161;quickSort
474400;185141204480;262143;8801361;9063504;8277075;0.040101;quickSort
474500;185236094480;262143;8803161;9065304;8278875;0.038797;quickSort
474600;185331004480;262143;8804961;9067104;8280675;0.038698;quickSort
474700;185425934480;262143;8806761;9068904;8282475;0.038708;quickSort
474800;185520884480;262143;8808561;9070704;8284275;0.038770;quickSort
474900;185615854480;262143;8810361;9072504;8286075;0.038875;quickSort
475000;185710844480;262143;8812161;9074304;8287875;0.038828;quickSort
475100;185805854480;262143;8813961;9076104;8289675;0.038822;quickSort
475200;185900884480;262143;8815761;9077904;8291475;0.039478;quickSort
475300;185995934480;262143;8817561;9079704;8293275;0.038844;quickSort
475400;1851091004480;262143;8819361;9081504;8295075;0.038833;quickSort
475500;1851186094480;262143;8821161;9083304;8296875;0.038759;quickSort
475600;186065452288;262143;8822961;9085104;8298675;0.039296;quickSort
475700;186160582288;262143;8824761;9086904;8300475;0.039101;quickSort
475800;186255732288;262143;8826561;9088704;8302275;0.038867;quickSort
475900;186350902288;262143;8828361;9090504;8304075;0.039646;quickSort
476000;186446092288;262143;8830161;9092304;8305875;0.039098;quickSort
476100;186541302288;262143;8831961;9094104;8307675;0.039008;quickSort
476200;186636532288;262143;8833761;9095904;8309475;0.039325;quickSort
476300;186731782288;262143;8835561;9097704;8311275;0.038945;quickSort
476400;186827052288;262143;8837361;9099504;8313075;0.039058;quickSort
476500;186922342288;262143;8839161;9101304;8314875;0.038981;quickSort
476600;1861017652288;262143;8840961;9103104;8316675;0.038941;quickSort
476700;1861112982288;262143;8842761;9104904;8318475;0.038907;quickSort
476800;1861208332288;262143;8844561;9106704;8320275;0.038983;quickSort
476900;187087950096;262143;8846361;9108504;8322075;0.038395;quickSort
477000;187183340096;262143;8848161;9110304;8323875;0.038258;quickSort
477100;187278750096;262143;8849961;9112104;8325675;0.038885;quickSort
477200;187374180096;262143;8851761;9113904;8327475;0.038998;quickSort
477300;187469630096;262143;8853561;9115704;8329275;0.038960;quickSort
477400;187565100096;262143;8855361;9117504;8331075;0.039057;quickSort
477500;187660590096;262143;8857161;9119304;8332875;0.038918;quickSort
477600;187756100096;262143;8858961;9121104;8334675;0.038969;quickSort
477700;187851630096;262143;8860761;9122904;8336475;0.038937;quickSort
477800;187947180096;262143;8862561;9124704;8338275;0.038995;quickSort
477900;1871042750096;262143;8864361;9126504;8340075;0.038942;quickSort
478000;1871138340096;262143;8866161;9128304;8341875;0.039024;quickSort
478100;188018197904;262143;8867961;9130104;8343675;0.039000;quickSort
478200;188113827904;262143;8869761;9131904;8345475;0.039041;quickSort
478300;188209477904;262143;8871561;9133704;8347275;0.038987;quickSort
478400;188305147904;262143;8873361;9135504;8349075;0.039056;quickSort
478500;188400837904;262143;8875161;9137304;8350875;0.038998;quickSort
478600;188496547904;262143;8876961;9139104;8352675;0.039703;quickSort
478700;188592277904;262143;8878761;9140904;8354475;0.039087;quickSort
478800;188688027904;262143;8880561;9142704;8356275;0.039177;quickSort
478900;188783797904;262143;8882361;9144504;8358075;0.039196;quickSort
479000;188879587904;262143;8884161;9146304;8359875;0.039050;quickSort
479100;188975397904;262143;8885961;9148104;8361675;0.039068;quickSort
479200;1881071227904;262143;8887761;9149904;8363475;0.039005;quickSort
479300;1881167077904;262143;8889561;9151704;8365275;0.039060;quickSort
479400;189047195712;262143;8891361;9153504;8367075;0.039042;quickSort
479500;189143085712;262143;8893161;9155304;8368875;0.039077;quickSort
479600;189238995712;262143;8894961;9157104;8370675;0.039136;quickSort
479700;189334925712;262143;8896761;9158904;8372475;0.038163;quickSort
479800;189430875712;262143;8898561;9160704;8374275;0.038536;quickSort
479900;189526845712;262143;8900361;9162504;8376075;0.039342;quickSort
480000;189622835712;262143;8902161;9164304;8377875;0.039092;quickSort
480100;189718845712;262143;8903961;9166104;8379675;0.039103;quickSort
480200;189814875712;262143;8905761;9167904;8381475;0.039150;quickSort
480300;189910925712;262143;8907561;9169704;8383275;0.039150;quickSort
480400;1891006995712;262143;8909361;9171504;8385075;0.039359;quickSort
480500;1891103085712;262143;8911161;9173304;8386875;0.039699;quickSort
480600;1891199195712;262143;8912961;9175104;8388675;0.039172;quickSort
480700;190079573520;262143;8914761;9176904;8390475;0.039342;quickSort
480800;190175723520;262143;8916561;9178704;8392275;0.039438;quickSort
480900;190271893520;262143;8918361;9180504;8394075;0.039427;quickSort
481000;190368083520;262143;8920161;9182304;8395875;0.039204;quickSort
481100;190464293520;262143;8921961;9184104;8397675;0.039557;quickSort
481200;190560523520;262143;8923761;9185904;8399475;0.039921;quickSort
481300;190656773520;262143;8925561;9187704;8401275;0.039521;quickSort
481400;190753043520;262143;8927361;9189504;8403075;0.039227;quickSort
481500;190849333520;262143;8929161;9191304;8404875;0.039366;quickSort
481600;190945643520;262143;8930961;9193104;8406675;0.039389;quickSort
481700;1901041973520;262143;8932761;9194904;8408475;0.039372;quickSort
481800;1901138323520;262143;8934561;9196704;8410275;0.041110;quickSort
481900;191018941328;262143;8936361;9198504;8412075;0.039220;quickSort
482000;191115331328;262143;8938161;9200304;8413875;0.039205;quickSort
482100;191211741328;262143;8939961;9202104;8415675;0.039222;quickSort
482200;191308171328;262143;8941761;9203904;8417475;0.039050;quickSort
482300;191404621328;262143;8943561;9205704;8419275;0.038881;quickSort
482400;191501091328;262143;8945361;9207504;8421075;0.039557;quickSort
482500;191597581328;262143;8947161;9209304;8422875;0.039217;quickSort
482600;191694091328;262143;8948961;9211104;8424675;0.039275;quickSort
482700;191790621328;262143;8950761;9212904;8426475;0.039376;quickSort
482800;191887171328;262143;8952561;9214704;8428275;0.039846;quickSort
482900;191983741328;262143;8954361;9216504;8430075;0.039653;quickSort
483000;1911080331328;262143;8956161;9218304;8431875;0.039582;quickSort
483100;1911176941328;262143;8957961;9220104;8433675;0.039605;quickSort
483200;192057819136;262143;8959761;9221904;8435475;0.039809;quickSort
483300;192154469136;262143;8961561;9223704;8437275;0.040012;quickSort
483400;192251139136;262143;8963361;9225504;8439075;0.039577;quickSort
483500;192347829136;262143;8965161;9227304;8440875;0.039386;quickSort
483600;192444539136;262143;8966961;9229104;8442675;0.039403;quickSort
483700;192541269136;262143;8968761;9230904;8444475;0.039353;quickSort
483800;192638019136;262143;8970561;9232704;8446275;0.039375;quickSort
483900;192734789136;262143;8972361;9234504;8448075;0.039411;quickSort
484000;192831579136;262143;8974161;9236304;8449875;0.039431;quickSort
484100;192928389136;262143;8975961;9238104;8451675;0.039440;quickSort
484200;1921025219136;262143;8977761;9239904;8453475;0.039432;quickSort
484300;1921122069136;262143;8979561;9241704;8455275;0.039532;quickSort
484400;193003186944;262143;8981361;9243504;8457075;0.040425;quickSort
484500;193100076944;262143;8983161;9245304;8458875;0.040461;quickSort
484600;193196986944;262143;8984961;9247104;8460675;0.040196;quickSort
484700;193293916944;262143;8986761;9248904;8462475;0.039768;quickSort
484800;193390866944;262143;8988561;9250704;8464275;0.039874;quickSort
484900;193487836944;262143;8990361;9252504;8466075;0.039910;quickSort
485000;193584826944;262143;8992161;9254304;8467875;0.040289;quickSort
485100;193681836944;262143;8993961;9256104;8469675;0.039551;quickSort
485200;193778866944;262143;8995761;9257904;8471475;0.039829;quickSort
485300;193875916944;262143;8997561;9259704;8473275;0.039769;quickSort
485400;193972986944;262143;8999361;9261504;8475075;0.040032;quickSort
485500;1931070076944;262143;9001161;9263304;8476875;0.039665;quickSort
485600;1931167186944;262143;9002961;9265104;8478675;0.040298;quickSort
485700;194048564752;262143;9004761;9266904;8480475;0.039458;quickSort
485800;194145714752;262143;9006561;9268704;8482275;0.039732;quickSort
485900;194242884752;262143;9008361;9270504;8484075;0.040005;quickSort
486000;194340074752;262143;9010161;9272304;8485875;0.039642;quickSort
486100;194437284752;262143;9011961;9274104;8487675;0.039565;quickSort
486200;194534514752;262143;9013761;9275904;8489475;0.039581;quickSort
486300;194631764752;262143;9015561;9277704;8491275;0.039568;quickSort
486400;194729034752;262143;9017361;9279504;8493075;0.039696;quickSort
486500;194826324752;262143;9019161;9281304;8494875;0.039649;quickSort
486600;194923634752;262143;9020961;9283104;8496675;0.040134;quickSort
486700;1941020964752;262143;9022761;9284904;8498475;0.039641;quickSort
486800;1941118314752;262143;9024561;9286704;8500275;0.039561;quickSort
486900;1941215684752;262143;9026361;9288504;8502075;0.039566;quickSort
487000;195097322560;262143;9028161;9290304;8503875;0.039598;quickSort
487100;195194732560;262143;9029961;9292104;8505675;0.039540;quickSort
487200;195292162560;262143;9031761;9293904;8507475;0.038613;quickSort
487300;195389612560;262143;9033561;9295704;8509275;0.038575;quickSort
487400;195487082560;262143;9035361;9297504;8511075;0.039340;quickSort
487500;195584572560;262143;9037161;9299304;8512875;0.039549;quickSort
487600;195682082560;262143;9038961;9301104;8514675;0.039637;quickSort
487700;195779612560;262143;9040761;9302904;8516475;0.039597;quickSort
487800;195877162560;262143;9042561;9304704;8518275;0.039539;quickSort
487900;195974732560;262143;9044361;9306504;8520075;0.039632;quickSort
488000;1951072322560;262143;9046161;9308304;8521875;0.039624;quickSort
488100;1951169932560;262143;9047961;9310104;8523675;0.040029;quickSort
488200;196051810368;262143;9049761;9311904;8525475;0.039598;quickSort
488300;196149460368;262143;9051561;9313704;8527275;0.039589;quickSort
488400;196247130368;262143;9053361;9315504;8529075;0.039644;quickSort
488500;196344820368;262143;9055161;9317304;8530875;0.039622;quickSort
488600;196442530368;262143;9056961;9319104;8532675;0.039629;quickSort
488700;196540260368;262143;9058761;9320904;8534475;0.039615;quickSort
488800;196638010368;262143;9060561;9322704;8536275;0.039690;quickSort
488900;196735780368;262143;9062361;9324504;8538075;0.039740;quickSort
489000;196833570368;262143;9064161;9326304;8539875;0.039689;quickSort
489100;196931380368;262143;9065961;9328104;8541675;0.039704;quickSort
489200;1961029210368;262143;9067761;9329904;8543475;0.039631;quickSort
489300;1961127060368;262143;9069561;9331704;8545275;0.039625;quickSort
489400;197009178176;262143;9071361;9333504;8547075;0.039715;quickSort
489500;197107068176;262143;9073161;9335304;8548875;0.039711;quickSort
489600;197204978176;262143;9074961;9337104;8550675;0.039693;quickSort
489700;197302908176;262143;9076761;9338904;8552475;0.039699;quickSort
489800;197400858176;262143;9078561;9340704;8554275;0.039739;quickSort
489900;197498828176;262143;9080361;9342504;8556075;0.039840;quickSort
490000;197596818176;262143;9082161;9344304;8557875;0.040355;quickSort
490100;197694828176;262143;9083961;9346104;8559675;0.040151;quickSort
490200;197792858176;262143;9085761;9347904;8561475;0.039983;quickSort
490300;197890908176;262143;9087561;9349704;8563275;0.041641;quickSort
490400;197988978176;262143;9089361;9351504;8565075;0.039856;quickSort
490500;1971087068176;262143;9091161;9353304;8566875;0.039924;quickSort
490600;1971185178176;262143;9092961;9355104;8568675;0.040625;quickSort
490700;198067555984;262143;9094761;9356904;8570475;0.039738;quickSort
490800;198165705984;262143;9096561;9358704;8572275;0.039735;quickSort
490900;198263875984;262143;9098361;9360504;8574075;0.039747;quickSort
491000;198362065984;262143;9100161;9362304;8575875;0.039781;quickSort
491100;198460275984;262143;9101961;9364104;8577675;0.039704;quickSort
491200;198558505984;262143;9103761;9365904;8579475;0.039783;quickSort
491300;198656755984;262143;9105561;9367704;8581275;0.039710;quickSort
491400;198755025984;262143;9107361;9369504;8583075;0.039840;quickSort
491500;198853315984;262143;9109161;9371304;8584875;0.039901;quickSort
491600;198951625984;262143;9110961;9373104;8586675;0.039911;quickSort
491700;1981049955984;262143;9112761;9374904;8588475;0.039813;quickSort
491800;1981148305984;262143;9114561;9376704;8590275;0.039894;quickSort
491900;199030923792;262143;9116361;9378504;8592075;0.039783;quickSort
492000;199129313792;262143;9118161;9380304;8593875;0.039752;quickSort
492100;199227723792;262143;9119961;9382104;8595675;0.039788;quickSort
492200;199326153792;262143;9121761;9383904;8597475;0.039822;quickSort
492300;199424603792;262143;9123561;9385704;8599275;0.039799;quickSort
492400;199523073792;262143;9125361;9387504;8601075;0.039952;quickSort
492500;199621563792;262143;9127161;9389304;8602875;0.039881;quickSort
492600;199720073792;262143;9128961;9391104;8604675;0.039832;quickSort
492700;199818603792;262143;9130761;9392904;8606475;0.039877;quickSort
492800;199917153792;262143;9132561;9394704;8608275;0.039838;quickSort
492900;1991015723792;262143;9134361;9396504;8610075;0.039861;quickSort
493000;1991114313792;262143;9136161;9398304;8611875;0.039831;quickSort
493100;1991212923792;262143;9137961;9400104;8613675;0.039974;quickSort
493200;200095801600;262143;9139761;9401904;8615475;0.039925;quickSort
493300;200194451600;262143;9141561;9403704;8617275;0.039961;quickSort
493400;200293121600;262143;9143361;9405504;8619075;0.039959;quickSort
493500;200391811600;262143;9145161;9407304;8620875;0.040008;quickSort
493600;200490521600;262143;9146961;9409104;8622675;0.039937;quickSort
493700;200589251600;262143;9148761;9410904;8624475;0.039996;quickSort
493800;200688001600;262143;9150561;9412704;8626275;0.040063;quickSort
493900;200786771600;262143;9152361;9414504;8628075;0.040023;quickSort
494000;200885561600;262143;9154161;9416304;8629875;0.039978;quickSort
494100;200984371600;262143;9155961;9418104;8631675;0.039904;quickSort
494200;2001083201600;262143;9157761;9419904;8633475;0.039981;quickSort
494300;2001182051600;262143;9159561;9421704;8635275;0.040057;quickSort
494400;201065169408;262143;9161361;9423504;8637075;0.040050;quickSort
494500;201164059408;262143;9163161;9425304;8638875;0.040428;quickSort
494600;201262969408;262143;9164961;9427104;8640675;0.040557;quickSort
494700;201361899408;262143;9166761;9428904;8642475;0.040402;quickSort
494800;201460849408;262143;9168561;9430704;8644275;0.041231;quickSort
494900;201559819408;262143;9170361;9432504;8646075;0.041503;quickSort
495000;201658809408;262143;9172161;9434304;8647875;0.041286;quickSort
495100;201757819408;262143;9173961;9436104;8649675;0.040140;quickSort
495200;201856849408;262143;9175761;9437904;8651475;0.040930;quickSort
495300;201955899408;262143;9177561;9439704;8653275;0.040476;quickSort
495400;2011054969408;262143;9179361;9441504;8655075;0.040258;quickSort
495500;2011154059408;262143;9181161;9443304;8656875;0.040806;quickSort
495600;202037417216;262143;9182961;9445104;8658675;0.040343;quickSort
495700;202136547216;262143;9184761;9446904;8660475;0.039474;quickSort
495800;202235697216;262143;9186561;9448704;8662275;0.040136;quickSort
495900;202334867216;262143;9188361;9450504;8664075;0.040132;quickSort
496000;202434057216;262143;9190161;9452304;8665875;0.040224;quickSort
496100;202533267216;262143;9191961;9454104;8667675;0.040055;quickSort
496200;202632497216;262143;9193761;9455904;8669475;0.040191;quickSort
496300;202731747216;262143;9195561;9457704;8671275;0.040142;quickSort
496400;202831017216;262143;9197361;9459504;8673075;0.040226;quickSort
496500;202930307216;262143;9199161;9461304;8674875;0.040120;quickSort
496600;2021029617216;262143;9200961;9463104;8676675;0.040183;quickSort
496700;2021128947216;262143;9202761;9464904;8678475;0.040189;quickSort
496800;203012545024;262143;9204561;9466704;8680275;0.040224;quickSort
496900;203111915024;262143;9206361;9468504;8682075;0.040221;quickSort
497000;203211305024;262143;9208161;9470304;8683875;0.040257;quickSort
497100;203310715024;262143;9209961;9472104;8685675;0.040193;quickSort
497200;203410145024;262143;9211761;9473904;8687475;0.040293;quickSort
497300;203509595024;262143;9213561;9475704;8689275;0.040154;quickSort
497400;203609065024;262143;9215361;9477504;8691075;0.040292;quickSort
497500;203708555024;262143;9217161;9479304;8692875;0.040240;quickSort
497600;203808065024;262143;9218961;9481104;8694675;0.040236;quickSort
497700;203907595024;262143;9220761;9482904;8696475;0.040307;quickSort
497800;2031007145024;262143;9222561;9484704;8698275;0.040284;quickSort
497900;2031106715024;262143;9224361;9486504;8700075;0.040274;quickSort
498000;2031206305024;262143;9226161;9488304;8701875;0.040273;quickSort
498100;204090162832;262143;9227961;9490104;8703675;0.040344;quickSort
498200;204189792832;262143;9229761;9491904;8705475;0.040193;quickSort
498300;204289442832;262143;9231561;9493704;8707275;0.040326;quickSort
498400;204389112832;262143;9233361;9495504;8709075;0.040175;quickSort
498500;204488802832;262143;9235161;9497304;8710875;0.040231;quickSort
498600;204588512832;262143;9236961;9499104;8712675;0.040350;quickSort
498700;204688242832;262143;9238761;9500904;8714475;0.040300;quickSort
498800;204787992832;262143;9240561;9502704;8716275;0.040244;quickSort
498900;204887762832;262143;9242361;9504504;8718075;0.040380;quickSort
499000;204987552832;262143;9244161;9506304;8719875;0.041392;quickSort
499100;2041087362832;262143;9245961;9508104;8721675;0.040820;quickSort
499200;2041187192832;262143;9247761;9509904;8723475;0.040488;quickSort
499300;205071290640;262143;9249561;9511704;8725275;0.040493;quickSort
499400;205171160640;262143;9251361;9513504;8727075;0.040528;quickSort
499500;205271050640;262143;9253161;9515304;8728875;0.040559;quickSort
499600;205370960640;262143;9254961;9517104;8730675;0.040672;quickSort
499700;205470890640;262143;9256761;9518904;8732475;0.040568;quickSort
499800;205570840640;262143;9258561;9520704;8734275;0.040425;quickSort
499900;205670810640;262143;9260361;9522504;8736075;0.041166;quickSort
500000;205770800640;262143;9262161;9524304;8737875;0.040477;quickSort
500100;205870810640;262143;9263961;9526104;8739675;0.040476;quickSort
500200;205970840640;262143;9265761;9527904;8741475;0.040482;quickSort
500300;2051070890640;262143;9267561;9529704;8743275;0.040399;quickSort
500400;2051170960640;262143;9269361;9531504;8745075;0.041974;quickSort
500500;206055298448;262143;9271161;9533304;8746875;0.040465;quickSort
500600;206155408448;262143;9272961;9535104;8748675;0.040477;quickSort
500700;206255538448;262143;9274761;9536904;8750475;0.040545;quickSort
500800;206355688448;262143;9276561;9538704;8752275;0.040448;quickSort
500900;206455858448;262143;9278361;9540504;8754075;0.040528;quickSort
501000;206556048448;262143;9280161;9542304;8755875;0.040644;quickSort
501100;206656258448;262143;9281961;9544104;8757675;0.040592;quickSort
501200;206756488448;262143;9283761;9545904;8759475;0.040505;quickSort
501300;206856738448;262143;9285561;9547704;8761275;0.040605;quickSort
501400;206957008448;262143;9287361;9549504;8763075;0.040718;quickSort
501500;2061057298448;262143;9289161;9551304;8764875;0.042940;quickSort
501600;2061157608448;262143;9290961;9553104;8766675;0.040712;quickSort
501700;207042186256;262143;9292761;9554904;8768475;0.040468;quickSort
501800;207142536256;262143;9294561;9556704;8770275;0.040555;quickSort
501900;207242906256;262143;9296361;9558504;8772075;0.040590;quickSort
502000;207343296256;262143;9298161;9560304;8773875;0.040534;quickSort
502100;207443706256;262143;9299961;9562104;8775675;0.040475;quickSort
502200;207544136256;262143;9301761;9563904;8777475;0.040571;quickSort
502300;207644586256;262143;9303561;9565704;8779275;0.040615;quickSort
502400;207745056256;262143;9305361;9567504;8781075;0.040703;quickSort
502500;207845546256;262143;9307161;9569304;8782875;0.041397;quickSort
502600;207946056256;262143;9308961;9571104;8784675;0.040675;quickSort
502700;2071046586256;262143;9310761;9572904;8786475;0.040386;quickSort
502800;2071147136256;262143;9312561;9574704;8788275;0.040497;quickSort
502900;208031954064;262143;9314361;9576504;8790075;0.040770;quickSort
503000;208132544064;262143;9316161;9578304;8791875;0.040844;quickSort
503100;208233154064;262143;9317961;9580104;8793675;0.040746;quickSort
503200;208333784064;262143;9319761;9581904;8795475;0.040726;quickSort
503300;208434434064;262143;9321561;9583704;8797275;0.040862;quickSort
503400;208535104064;262143;9323361;9585504;8799075;0.040822;quickSort
503500;208635794064;262143;9325161;9587304;8800875;0.040827;quickSort
503600;208736504064;262143;9326961;9589104;8802675;0.040830;quickSort
503700;208837234064;262143;9328761;9590904;8804475;0.040978;quickSort
503800;208937984064;262143;9330561;9592704;8806275;0.045581;quickSort
503900;2081038754064;262143;9332361;9594504;8808075;0.042576;quickSort
504000;2081139544064;262143;9334161;9596304;8809875;0.040821;quickSort
504100;209024601872;262143;9335961;9598104;8811675;0.040772;quickSort
504200;209125431872;262143;9337761;9599904;8813475;0.040890;quickSort
504300;209226281872;262143;9339561;9601704;8815275;0.043010;quickSort
504400;209327151872;262143;9341361;9603504;8817075;0.040968;quickSort
504500;209428041872;262143;9343161;9605304;8818875;0.042078;quickSort
504600;209528951872;262143;9344961;9607104;8820675;0.042282;quickSort
504700;209629881872;262143;9346761;9608904;8822475;0.041654;quickSort
504800;209730831872;262143;9348561;9610704;8824275;0.040798;quickSort
504900;209831801872;262143;9350361;9612504;8826075;0.040728;quickSort
505000;209932791872;262143;9352161;9614304;8827875;0.040808;quickSort
505100;2091033801872;262143;9353961;9616104;8829675;0.040796;quickSort
505200;2091134831872;262143;9355761;9617904;8831475;0.040854;quickSort
505300;210020129680;262143;9357561;9619704;8833275;0.040775;quickSort
505400;210121199680;262143;9359361;9621504;8835075;0.041457;quickSort
505500;210222289680;262143;9361161;9623304;8836875;0.041209;quickSort
505600;210323399680;262143;9362961;9625104;8838675;0.040878;quickSort
505700;210424529680;262143;9364761;9626904;8840475;0.040855;quickSort
505800;210525679680;262143;9366561;9628704;8842275;0.040828;quickSort
505900;210626849680;262143;9368361;9630504;8844075;0.040839;quickSort
506000;210728039680;262143;9370161;9632304;8845875;0.040908;quickSort
506100;210829249680;262143;9371961;9634104;8847675;0.041814;quickSort
506200;210930479680;262143;9373761;9635904;8849475;0.041421;quickSort
506300;2101031729680;262143;9375561;9637704;8851275;0.040969;quickSort
506400;2101132999680;262143;9377361;9639504;8853075;0.041194;quickSort
506500;211018537488;262143;9379161;9641304;8854875;0.040949;quickSort
506600;211119847488;262143;9380961;9643104;8856675;0.040892;quickSort
506700;211221177488;262143;9382761;9644904;8858475;0.040973;quickSort
506800;211322527488;262143;9384561;9646704;8860275;0.040947;quickSort
506900;211423897488;262143;9386361;9648504;8862075;0.040964;quickSort
507000;211525287488;262143;9388161;9650304;8863875;0.040885;quickSort
507100;211626697488;262143;9389961;9652104;8865675;0.041104;quickSort
507200;211728127488;262143;9391761;9653904;8867475;0.041028;quickSort
507300;211829577488;262143;9393561;9655704;8869275;0.041788;quickSort
507400;211931047488;262143;9395361;9657504;8871075;0.040982;quickSort
507500;2111032537488;262143;9397161;9659304;8872875;0.041030;quickSort
507600;2111134047488;262143;9398961;9661104;8874675;0.041031;quickSort
507700;212019825296;262143;9400761;9662904;8876475;0.041024;quickSort
507800;212121375296;262143;9402561;9664704;8878275;0.040992;quickSort
507900;212222945296;262143;9404361;9666504;8880075;0.041043;quickSort
508000;212324535296;262143;9406161;9668304;8881875;0.041048;quickSort
508100;212426145296;262143;9407961;9670104;8883675;0.041086;quickSort
508200;212527775296;262143;9409761;9671904;8885475;0.041168;quickSort
508300;212629425296;262143;9411561;9673704;8887275;0.041028;quickSort
508400;212731095296;262143;9413361;9675504;8889075;0.041097;quickSort
508500;212832785296;262143;9415161;9677304;8890875;0.041071;quickSort
508600;212934495296;262143;9416961;9679104;8892675;0.041088;quickSort
508700;2121036225296;262143;9418761;9680904;8894475;0.041109;quickSort
508800;2121137975296;262143;9420561;9682704;8896275;0.041081;quickSort
508900;213023993104;262143;9422361;9684504;8898075;0.040290;quickSort
509000;213125783104;262143;9424161;9686304;8899875;0.040813;quickSort
509100;213227593104;262143;9425961;9688104;8901675;0.041117;quickSort
509200;213329423104;262143;9427761;9689904;8903475;0.040340;quickSort
509300;213431273104;262143;9429561;9691704;8905275;0.040088;quickSort
509400;213533143104;262143;9431361;9693504;8907075;0.041106;quickSort
509500;213635033104;262143;9433161;9695304;8908875;0.041157;quickSort
509600;213736943104;262143;9434961;9697104;8910675;0.041137;quickSort
509700;213838873104;262143;9436761;9698904;8912475;0.041146;quickSort
509800;213940823104;262143;9438561;9700704;8914275;0.041168;quickSort
509900;2131042793104;262143;9440361;9702504;8916075;0.041213;quickSort
510000;2131144783104;262143;9442161;9704304;8917875;0.041096;quickSort
510100;214031040912;262143;9443961;9706104;8919675;0.041257;quickSort
510200;214133070912;262143;9445761;9707904;8921475;0.041173;quickSort
510300;214235120912;262143;9447561;9709704;8923275;0.041288;quickSort
510400;214337190912;262143;9449361;9711504;8925075;0.041185;quickSort
510500;214439280912;262143;9451161;9713304;8926875;0.041218;quickSort
510600;214541390912;262143;9452961;9715104;8928675;0.041370;quickSort
510700;214643520912;262143;9454761;9716904;8930475;0.041524;quickSort
510800;214745670912;262143;9456561;9718704;8932275;0.041435;quickSort
510900;214847840912;262143;9458361;9720504;8934075;0.041383;quickSort
511000;214950030912;262143;9460161;9722304;8935875;0.041932;quickSort
511100;2141052240912;262143;9461961;9724104;8937675;0.041292;quickSort
511200;2141154470912;262143;9463761;9725904;8939475;0.042342;quickSort
511300;215040968720;262143;9465561;9727704;8941275;0.042055;quickSort
511400;215143238720;262143;9467361;9729504;8943075;0.044838;quickSort
511500;215245528720;262143;9469161;9731304;8944875;0.046647;quickSort
511600;215347838720;262143;9470961;9733104;8946675;0.042069;quickSort
511700;215450168720;262143;9472761;9734904;8948475;0.044921;quickSort
511800;215552518720;262143;9474561;9736704;8950275;0.043160;quickSort
511900;215654888720;262143;9476361;9738504;8952075;0.041581;quickSort
512000;215757278720;262143;9478161;9740304;8953875;0.041973;quickSort
512100;215859688720;262143;9479961;9742104;8955675;0.045386;quickSort
512200;215962118720;262143;9481761;9743904;8957475;0.045384;quickSort
512300;2151064568720;262143;9483561;9745704;8959275;0.042710;quickSort
512400;2151167038720;262143;9485361;9747504;8961075;0.041665;quickSort
512500;216053776528;262143;9487161;9749304;8962875;0.041539;quickSort
512600;216156286528;262143;9488961;9751104;8964675;0.041402;quickSort
512700;216258816528;262143;9490761;9752904;8966475;0.041338;quickSort
512800;216361366528;262143;9492561;9754704;8968275;0.041388;quickSort
512900;216463936528;262143;9494361;9756504;8970075;0.041272;quickSort
513000;216566526528;262143;9496161;9758304;8971875;0.041345;quickSort
513100;216669136528;262143;9497961;9760104;8973675;0.041458;quickSort
513200;216771766528;262143;9499761;9761904;8975475;0.041380;quickSort
513300;216874416528;262143;9501561;9763704;8977275;0.041448;quickSort
513400;216977086528;262143;9503361;9765504;8979075;0.041402;quickSort
513500;2161079776528;262143;9505161;9767304;8980875;0.041746;quickSort
513600;2161182486528;262143;9506961;9769104;8982675;0.044311;quickSort
513700;217069464336;262143;9508761;9770904;8984475;0.042779;quickSort
513800;217172214336;262143;9510561;9772704;8986275;0.041505;quickSort
513900;217274984336;262143;9512361;9774504;8988075;0.041491;quickSort
514000;217377774336;262143;9514161;9776304;8989875;0.041542;quickSort
514100;217480584336;262143;9515961;9778104;8991675;0.042900;quickSort
514200;217583414336;262143;9517761;9779904;8993475;0.041416;quickSort
514300;217686264336;262143;9519561;9781704;8995275;0.041415;quickSort
514400;217789134336;262143;9521361;9783504;8997075;0.041513;quickSort
514500;217892024336;262143;9523161;9785304;8998875;0.041482;quickSort
514600;217994934336;262143;9524961;9787104;9000675;0.041437;quickSort
514700;2171097864336;262143;9526761;9788904;9002475;0.041479;quickSort
514800;2171200814336;262143;9528561;9790704;9004275;0.041501;quickSort
514900;218088032144;262143;9530361;9792504;9006075;0.041432;quickSort
515000;218191022144;262143;9532161;9794304;9007875;0.041543;quickSort
515100;218294032144;262143;9533961;9796104;9009675;0.041460;quickSort
515200;218397062144;262143;9535761;9797904;9011475;0.041471;quickSort
515300;218500112144;262143;9537561;9799704;9013275;0.041858;quickSort
515400;218603182144;262143;9539361;9801504;9015075;0.041528;quickSort
515500;218706272144;262143;9541161;9803304;9016875;0.041716;quickSort
515600;218809382144;262143;9542961;9805104;9018675;0.041548;quickSort
515700;218912512144;262143;9544761;9806904;9020475;0.041507;quickSort
515800;2181015662144;262143;9546561;9808704;9022275;0.042775;quickSort
515900;2181118832144;262143;9548361;9810504;9024075;0.041593;quickSort
516000;219006269952;262143;9550161;9812304;9025875;0.041616;quickSort
516100;219109479952;262143;9551961;9814104;9027675;0.041526;quickSort
516200;219212709952;262143;9553761;9815904;9029475;0.041583;quickSort
516300;219315959952;262143;9555561;9817704;9031275;0.041859;quickSort
516400;219419229952;262143;9557361;9819504;9033075;0.041559;quickSort
516500;219522519952;262143;9559161;9821304;9034875;0.041583;quickSort
516600;219625829952;262143;9560961;9823104;9036675;0.041702;quickSort
516700;219729159952;262143;9562761;9824904;9038475;0.041067;quickSort
516800;219832509952;262143;9564561;9826704;9040275;0.041643;quickSort
516900;219935879952;262143;9566361;9828504;9042075;0.041622;quickSort
517000;2191039269952;262143;9568161;9830304;9043875;0.041694;quickSort
517100;2191142679952;262143;9569961;9832104;9045675;0.041611;quickSort
517200;220030357760;262143;9571761;9833904;9047475;0.041623;quickSort
517300;220133807760;262143;9573561;9835704;9049275;0.041667;quickSort
517400;220237277760;262143;9575361;9837504;9051075;0.041661;quickSort
517500;220340767760;262143;9577161;9839304;9052875;0.041659;quickSort
517600;220444277760;262143;9578961;9841104;9054675;0.041719;quickSort
517700;220547807760;262143;9580761;9842904;9056475;0.041629;quickSort
517800;220651357760;262143;9582561;9844704;9058275;0.040942;quickSort
517900;220754927760;262143;9584361;9846504;9060075;0.041167;quickSort
518000;220858517760;262143;9586161;9848304;9061875;0.040712;quickSort
518100;220962127760;262143;9587961;9850104;9063675;0.041749;quickSort
518200;2201065757760;262143;9589761;9851904;9065475;0.042660;quickSort
518300;2201169407760;262143;9591561;9853704;9067275;0.041713;quickSort
518400;221057325568;262143;9593361;9855504;9069075;0.044000;quickSort
518500;221161015568;262143;9595161;9857304;9070875;0.042485;quickSort
518600;221264725568;262143;9596961;9859104;9072675;0.041702;quickSort
518700;221368455568;262143;9598761;9860904;9074475;0.042172;quickSort
518800;221472205568;262143;9600561;9862704;9076275;0.042278;quickSort
518900;221575975568;262143;9602361;9864504;9078075;0.042655;quickSort
519000;221679765568;262143;9604161;9866304;9079875;0.042227;quickSort
519100;221783575568;262143;9605961;9868104;9081675;0.042363;quickSort
519200;221887405568;262143;9607761;9869904;9083475;0.042352;quickSort
519300;221991255568;262143;9609561;9871704;9085275;0.041907;quickSort
519400;2211095125568;262143;9611361;9873504;9087075;0.042029;quickSort
519500;2211199015568;262143;9613161;9875304;9088875;0.041743;quickSort
519600;222087173376;262143;9614961;9877104;9090675;0.042104;quickSort
519700;222191103376;262143;9616761;9878904;9092475;0.042071;quickSort
519800;222295053376;262143;9618561;9880704;9094275;0.042166;quickSort
519900;222399023376;262143;9620361;9882504;9096075;0.041894;quickSort
520000;222503013376;262143;9622161;9884304;9097875;0.042585;quickSort
520100;222607023376;262143;9623961;9886104;9099675;0.041152;quickSort
520200;222711053376;262143;9625761;9887904;9101475;0.041195;quickSort
520300;222815103376;262143;9627561;9889704;9103275;0.041724;quickSort
520400;222919173376;262143;9629361;9891504;9105075;0.041757;quickSort
520500;2221023263376;262143;9631161;9893304;9106875;0.041711;quickSort
520600;2221127373376;262143;9632961;9895104;9108675;0.041850;quickSort
520700;223015751184;262143;9634761;9896904;9110475;0.041841;quickSort
520800;223119901184;262143;9636561;9898704;9112275;0.041876;quickSort
520900;223224071184;262143;9638361;9900504;9114075;0.041858;quickSort
521000;223328261184;262143;9640161;9902304;9115875;0.041734;quickSort
521100;223432471184;262143;9641961;9904104;9117675;0.041702;quickSort
521200;223536701184;262143;9643761;9905904;9119475;0.041927;quickSort
521300;223640951184;262143;9645561;9907704;9121275;0.041878;quickSort
521400;223745221184;262143;9647361;9909504;9123075;0.041817;quickSort
521500;223849511184;262143;9649161;9911304;9124875;0.041914;quickSort
521600;223953821184;262143;9650961;9913104;9126675;0.041875;quickSort
521700;2231058151184;262143;9652761;9914904;9128475;0.043696;quickSort
521800;2231162501184;262143;9654561;9916704;9130275;0.042143;quickSort
521900;224051118992;262143;9656361;9918504;9132075;0.044119;quickSort
522000;224155508992;262143;9658161;9920304;9133875;0.041982;quickSort
522100;224259918992;262143;9659961;9922104;9135675;0.042555;quickSort
522200;224364348992;262143;9661761;9923904;9137475;0.042627;quickSort
522300;224468798992;262143;9663561;9925704;9139275;0.041915;quickSort
522400;224573268992;262143;9665361;9927504;9141075;0.041969;quickSort
522500;224677758992;262143;9667161;9929304;9142875;0.042914;quickSort
522600;224782268992;262143;9668961;9931104;9144675;0.043847;quickSort
522700;224886798992;262143;9670761;9932904;9146475;0.042702;quickSort
522800;224991348992;262143;9672561;9934704;9148275;0.042046;quickSort
522900;2241095918992;262143;9674361;9936504;9150075;0.044314;quickSort
523000;2241200508992;262143;9676161;9938304;9151875;0.042241;quickSort
523100;225089366800;262143;9677961;9940104;9153675;0.042015;quickSort
523200;225193996800;262143;9679761;9941904;9155475;0.045428;quickSort
523300;225298646800;262143;9681561;9943704;9157275;0.042082;quickSort
523400;225403316800;262143;9683361;9945504;9159075;0.042487;quickSort
523500;225508006800;262143;9685161;9947304;9160875;0.042062;quickSort
523600;225612716800;262143;9686961;9949104;9162675;0.043518;quickSort
523700;225717446800;262143;9688761;9950904;9164475;0.042718;quickSort
523800;225822196800;262143;9690561;9952704;9166275;0.043018;quickSort
523900;225926966800;262143;9692361;9954504;9168075;0.042943;quickSort
524000;2251031756800;262143;9694161;9956304;9169875;0.043082;quickSort
524100;2251136566800;262143;9695961;9958104;9171675;0.042922;quickSort
524200;226025644608;262143;9697761;9959904;9173475;0.042754;quickSort
524300;226130494608;262156;9699613;9961769;9175301;0.042935;quickSort
524400;226235364608;262256;9701813;9964069;9177301;0.041962;quickSort
524500;226340254608;262356;9704013;9966369;9179301;0.042359;quickSort
524600;226445164608;262456;9706213;9968669;9181301;0.042169;quickSort
524700;226550094608;262556;9708413;9970969;9183301;0.042071;quickSort
524800;226655044608;262656;9710613;9973269;9185301;0.042072;quickSort
524900;226760014608;262756;9712813;9975569;9187301;0.042105;quickSort
525000;226865004608;262856;9715013;9977869;9189301;0.042047;quickSort
525100;226970014608;262956;9717213;9980169;9191301;0.042048;quickSort
525200;2261075044608;263056;9719413;9982469;9193301;0.042103;quickSort
525300;2261180094608;263156;9721613;9984769;9195301;0.042171;quickSort
525400;227069412416;263256;9723813;9987069;9197301;0.042108;quickSort
525500;227174502416;263356;9726013;9989369;9199301;0.042072;quickSort
525600;227279612416;263456;9728213;9991669;9201301;0.042082;quickSort
525700;227384742416;263556;9730413;9993969;9203301;0.042218;quickSort
525800;227489892416;263656;9732613;9996269;9205301;0.042114;quickSort
525900;227595062416;263756;9734813;9998569;9207301;0.042175;quickSort
526000;227700252416;263856;9737013;10000869;9209301;0.042154;quickSort
526100;227805462416;263956;9739213;10003169;9211301;0.042222;quickSort
526200;227910692416;264056;9741413;10005469;9213301;0.042173;quickSort
526300;2271015942416;264156;9743613;10007769;9215301;0.042262;quickSort
526400;2271121212416;264256;9745813;10010069;9217301;0.042194;quickSort
526500;228010750224;264356;9748013;10012369;9219301;0.042246;quickSort
526600;228116060224;264456;9750213;10014669;9221301;0.042271;quickSort
526700;228221390224;264556;9752413;10016969;9223301;0.042275;quickSort
526800;228326740224;264656;9754613;10019269;9225301;0.042312;quickSort
526900;228432110224;264756;9756813;10021569;9227301;0.042342;quickSort
527000;228537500224;264856;9759013;10023869;9229301;0.042393;quickSort
527100;228642910224;264956;9761213;10026169;9231301;0.043764;quickSort
527200;228748340224;265056;9763413;10028469;9233301;0.042388;quickSort
527300;228853790224;265156;9765613;10030769;9235301;0.042384;quickSort
527400;228959260224;265256;9767813;10033069;9237301;0.042372;quickSort
527500;2281064750224;265356;9770013;10035369;9239301;0.042412;quickSort
527600;2281170260224;265456;9772213;10037669;9241301;0.042423;quickSort
527700;229060038032;265556;9774413;10039969;9243301;0.042382;quickSort
527800;229165588032;265656;9776613;10042269;9245301;0.042347;quickSort
527900;229271158032;265756;9778813;10044569;9247301;0.041423;quickSort
528000;229376748032;265856;9781013;10046869;9249301;0.042720;quickSort
528100;229482358032;265956;9783213;10049169;9251301;0.042484;quickSort
528200;229587988032;266056;9785413;10051469;9253301;0.042510;quickSort
528300;229693638032;266156;9787613;10053769;9255301;0.042494;quickSort
528400;229799308032;266256;9789813;10056069;9257301;0.041516;quickSort
528500;229904998032;266356;9792013;10058369;9259301;0.041634;quickSort
528600;2291010708032;266456;9794213;10060669;9261301;0.042523;quickSort
528700;2291116438032;266556;9796413;10062969;9263301;0.042526;quickSort
528800;230006435840;266656;9798613;10065269;9265301;0.042518;quickSort
528900;230112205840;266756;9800813;10067569;9267301;0.042570;quickSort
529000;230217995840;266856;9803013;10069869;9269301;0.042632;quickSort
529100;230323805840;266956;9805213;10072169;9271301;0.042725;quickSort
529200;230429635840;267056;9807413;10074469;9273301;0.042581;quickSort
529300;230535485840;267156;9809613;10076769;9275301;0.042686;quickSort
529400;230641355840;267256;9811813;10079069;9277301;0.042616;quickSort
529500;230747245840;267356;9814013;10081369;9279301;0.042621;quickSort
529600;230853155840;267456;9816213;10083669;9281301;0.042599;quickSort
529700;230959085840;267556;9818413;10085969;9283301;0.042565;quickSort
529800;2301065035840;267656;9820613;10088269;9285301;0.042702;quickSort
529900;2301171005840;267756;9822813;10090569;9287301;0.044468;quickSort
530000;231061243648;267856;9825013;10092869;9289301;0.042682;quickSort
530100;231167253648;267956;9827213;10095169;9291301;0.042690;quickSort
530200;231273283648;268056;9829413;10097469;9293301;0.042734;quickSort
530300;231379333648;268156;9831613;10099769;9295301;0.042814;quickSort
530400;231485403648;268256;9833813;10102069;9297301;0.042794;quickSort
530500;231591493648;268356;9836013;10104369;9299301;0.042781;quickSort
530600;231697603648;268456;9838213;10106669;9301301;0.042984;quickSort
530700;231803733648;268556;9840413;10108969;9303301;0.043333;quickSort
530800;231909883648;268656;9842613;10111269;9305301;0.043126;quickSort
530900;2311016053648;268756;9844813;10113569;9307301;0.043007;quickSort
531000;2311122243648;268856;9847013;10115869;9309301;0.043016;quickSort
531100;232012701456;268956;9849213;10118169;9311301;0.043153;quickSort
531200;232118931456;269056;9851413;10120469;9313301;0.042901;quickSort
531300;232225181456;269156;9853613;10122769;9315301;0.042888;quickSort
531400;232331451456;269256;9855813;10125069;9317301;0.042930;quickSort
531500;232437741456;269356;9858013;10127369;9319301;0.043795;quickSort
531600;232544051456;269456;9860213;10129669;9321301;0.042979;quickSort
531700;232650381456;269556;9862413;10131969;9323301;0.042888;quickSort
531800;232756731456;269656;9864613;10134269;9325301;0.042888;quickSort
531900;232863101456;269756;9866813;10136569;9327301;0.043064;quickSort
532000;232969491456;269856;9869013;10138869;9329301;0.042981;quickSort
532100;2321075901456;269956;9871213;10141169;9331301;0.043171;quickSort
532200;2321182331456;270056;9873413;10143469;9333301;0.042982;quickSort
532300;233073029264;270156;9875613;10145769;9335301;0.042979;quickSort
532400;233179499264;270256;9877813;10148069;9337301;0.043001;quickSort
532500;233285989264;270356;9880013;10150369;9339301;0.043173;quickSort
532600;233392499264;270456;9882213;10152669;9341301;0.043026;quickSort
532700;233499029264;270556;9884413;10154969;9343301;0.043010;quickSort
532800;233605579264;270656;9886613;10157269;9345301;0.043021;quickSort
532900;233712149264;270756;9888813;10159569;9347301;0.043086;quickSort
533000;233818739264;270856;9891013;10161869;9349301;0.042018;quickSort
533100;233925349264;270956;9893213;10164169;9351301;0.043250;quickSort
533200;2331031979264;271056;9895413;10166469;9353301;0.043073;quickSort
533300;2331138629264;271156;9897613;10168769;9355301;0.043141;quickSort
533400;234029547072;271256;9899813;10171069;9357301;0.043134;quickSort
533500;234136237072;271356;9902013;10173369;9359301;0.043127;quickSort
533600;234242947072;271456;9904213;10175669;9361301;0.043126;quickSort
533700;234349677072;271556;9906413;10177969;9363301;0.043095;quickSort
533800;234456427072;271656;9908613;10180269;9365301;0.043285;quickSort
533900;234563197072;271756;9910813;10182569;9367301;0.043347;quickSort
534000;234669987072;271856;9913013;10184869;9369301;0.042093;quickSort
534100;234776797072;271956;9915213;10187169;9371301;0.043157;quickSort
534200;234883627072;272056;9917413;10189469;9373301;0.043189;quickSort
534300;234990477072;272156;9919613;10191769;9375301;0.043342;quickSort
534400;2341097347072;272256;9921813;10194069;9377301;0.043264;quickSort
534500;2341204237072;272356;9924013;10196369;9379301;0.042171;quickSort
534600;235095394880;272456;9926213;10198669;9381301;0.042170;quickSort
534700;235202324880;272556;9928413;10200969;9383301;0.043300;quickSort
534800;235309274880;272656;9930613;10203269;9385301;0.043211;quickSort
534900;235416244880;272756;9932813;10205569;9387301;0.043322;quickSort
535000;235523234880;272856;9935013;10207869;9389301;0.043285;quickSort
535100;235630244880;272956;9937213;10210169;9391301;0.043295;quickSort
535200;235737274880;273056;9939413;10212469;9393301;0.043304;quickSort
535300;235844324880;273156;9941613;10214769;9395301;0.043348;quickSort
535400;235951394880;273256;9943813;10217069;9397301;0.043449;quickSort
535500;2351058484880;273356;9946013;10219369;9399301;0.043608;quickSort
535600;2351165594880;273456;9948213;10221669;9401301;0.043502;quickSort
535700;236056972688;273556;9950413;10223969;9403301;0.043423;quickSort
535800;236164122688;273656;9952613;10226269;9405301;0.043406;quickSort
535900;236271292688;273756;9954813;10228569;9407301;0.043453;quickSort
536000;236378482688;273856;9957013;10230869;9409301;0.043640;quickSort
536100;236485692688;273956;9959213;10233169;9411301;0.043755;quickSort
536200;236592922688;274056;9961413;10235469;9413301;0.043465;quickSort
536300;236700172688;274156;9963613;10237769;9415301;0.043628;quickSort
536400;236807442688;274256;9965813;10240069;9417301;0.043701;quickSort
536500;236914732688;274356;9968013;10242369;9419301;0.043559;quickSort
536600;2361022042688;274456;9970213;10244669;9421301;0.043550;quickSort
536700;2361129372688;274556;9972413;10246969;9423301;0.043554;quickSort
536800;237020970496;274656;9974613;10249269;9425301;0.043582;quickSort
536900;237128340496;274756;9976813;10251569;9427301;0.043657;quickSort
537000;237235730496;274856;9979013;10253869;9429301;0.043819;quickSort
537100;237343140496;274956;9981213;10256169;9431301;0.044106;quickSort
537200;237450570496;275056;9983413;10258469;9433301;0.044240;quickSort
537300;237558020496;275156;9985613;10260769;9435301;0.044056;quickSort
537400;237665490496;275256;9987813;10263069;9437301;0.044167;quickSort
537500;237772980496;275356;9990013;10265369;9439301;0.043984;quickSort
537600;237880490496;275456;9992213;10267669;9441301;0.043704;quickSort
537700;237988020496;275556;9994413;10269969;9443301;0.043644;quickSort
537800;2371095570496;275656;9996613;10272269;9445301;0.043805;quickSort
537900;2371203140496;275756;9998813;10274569;9447301;0.043725;quickSort
538000;238094978304;275856;10001013;10276869;9449301;0.043586;quickSort
538100;238202588304;275956;10003213;10279169;9451301;0.043638;quickSort
538200;238310218304;276056;10005413;10281469;9453301;0.043775;quickSort
538300;238417868304;276156;10007613;10283769;9455301;0.043634;quickSort
538400;238525538304;276256;10009813;10286069;9457301;0.043655;quickSort
538500;238633228304;276356;10012013;10288369;9459301;0.043787;quickSort
538600;238740938304;276456;10014213;10290669;9461301;0.043869;quickSort
538700;238848668304;276556;10016413;10292969;9463301;0.043756;quickSort
538800;238956418304;276656;10018613;10295269;9465301;0.043692;quickSort
538900;2381064188304;276756;10020813;10297569;9467301;0.043836;quickSort
539000;2381171978304;276856;10023013;10299869;9469301;0.043885;quickSort
539100;239064036112;276956;10025213;10302169;9471301;0.043972;quickSort
539200;239171866112;277056;10027413;10304469;9473301;0.043737;quickSort
539300;239279716112;277156;10029613;10306769;9475301;0.045915;quickSort
539400;239387586112;277256;10031813;10309069;9477301;0.043784;quickSort
539500;239495476112;277356;10034013;10311369;9479301;0.043853;quickSort
539600;239603386112;277456;10036213;10313669;9481301;0.043864;quickSort
539700;239711316112;277556;10038413;10315969;9483301;0.044221;quickSort
539800;239819266112;277656;10040613;10318269;9485301;0.043880;quickSort
539900;239927236112;277756;10042813;10320569;9487301;0.043860;quickSort
540000;2391035226112;277856;10045013;10322869;9489301;0.043990;quickSort
540100;2391143236112;277956;10047213;10325169;9491301;0.043965;quickSort
540200;240035513920;278056;10049413;10327469;9493301;0.045191;quickSort
540300;240143563920;278156;10051613;10329769;9495301;0.043864;quickSort
540400;240251633920;278256;10053813;10332069;9497301;0.044109;quickSort
540500;240359723920;278356;10056013;10334369;9499301;0.044033;quickSort
540600;240467833920;278456;10058213;10336669;9501301;0.043978;quickSort
540700;240575963920;278556;10060413;10338969;9503301;0.042867;quickSort
540800;240684113920;278656;10062613;10341269;9505301;0.043359;quickSort
540900;240792283920;278756;10064813;10343569;9507301;0.044120;quickSort
541000;240900473920;278856;10067013;10345869;9509301;0.043967;quickSort
541100;2401008683920;278956;10069213;10348169;9511301;0.044221;quickSort
541200;2401116913920;279056;10071413;10350469;9513301;0.044017;quickSort
541300;241009411728;279156;10073613;10352769;9515301;0.044553;quickSort
541400;241117681728;279256;10075813;10355069;9517301;0.044186;quickSort
541500;241225971728;279356;10078013;10357369;9519301;0.044168;quickSort
541600;241334281728;279456;10080213;10359669;9521301;0.044218;quickSort
541700;241442611728;279556;10082413;10361969;9523301;0.044113;quickSort
541800;241550961728;279656;10084613;10364269;9525301;0.044325;quickSort
541900;241659331728;279756;10086813;10366569;9527301;0.045463;quickSort
542000;241767721728;279856;10089013;10368869;9529301;0.044140;quickSort
542100;241876131728;279956;10091213;10371169;9531301;0.044220;quickSort
542200;241984561728;280056;10093413;10373469;9533301;0.044108;quickSort
542300;2411093011728;280156;10095613;10375769;9535301;0.044088;quickSort
542400;2411201481728;280256;10097813;10378069;9537301;0.044103;quickSort
542500;242094219536;280356;10100013;10380369;9539301;0.044214;quickSort
542600;242202729536;280456;10102213;10382669;9541301;0.044279;quickSort
542700;242311259536;280556;10104413;10384969;9543301;0.044291;quickSort
542800;242419809536;280656;10106613;10387269;9545301;0.044420;quickSort
542900;242528379536;280756;10108813;10389569;9547301;0.044165;quickSort
543000;242636969536;280856;10111013;10391869;9549301;0.044294;quickSort
543100;242745579536;280956;10113213;10394169;9551301;0.044348;quickSort
543200;242854209536;281056;10115413;10396469;9553301;0.044125;quickSort
543300;242962859536;281156;10117613;10398769;9555301;0.044769;quickSort
543400;2421071529536;281256;10119813;10401069;9557301;0.044695;quickSort
543500;2421180219536;281356;10122013;10403369;9559301;0.044486;quickSort
543600;243073177344;281456;10124213;10405669;9561301;0.044557;quickSort
543700;243181907344;281556;10126413;10407969;9563301;0.044236;quickSort
543800;243290657344;281656;10128613;10410269;9565301;0.044361;quickSort
543900;243399427344;281756;10130813;10412569;9567301;0.043902;quickSort
544000;243508217344;281856;10133013;10414869;9569301;0.044370;quickSort
544100;243617027344;281956;10135213;10417169;9571301;0.044362;quickSort
544200;243725857344;282056;10137413;10419469;9573301;0.044445;quickSort
544300;243834707344;282156;10139613;10421769;9575301;0.044376;quickSort
544400;243943577344;282256;10141813;10424069;9577301;0.044575;quickSort
544500;2431052467344;282356;10144013;10426369;9579301;0.045063;quickSort
544600;2431161377344;282456;10146213;10428669;9581301;0.045173;quickSort
544700;244054555152;282556;10148413;10430969;9583301;0.044470;quickSort
544800;244163505152;282656;10150613;10433269;9585301;0.044413;quickSort
544900;244272475152;282756;10152813;10435569;9587301;0.044429;quickSort
545000;244381465152;282856;10155013;10437869;9589301;0.044480;quickSort
545100;244490475152;282956;10157213;10440169;9591301;0.044480;quickSort
545200;244599505152;283056;10159413;10442469;9593301;0.044467;quickSort
545300;244708555152;283156;10161613;10444769;9595301;0.044512;quickSort
545400;244817625152;283256;10163813;10447069;9597301;0.044573;quickSort
545500;244926715152;283356;10166013;10449369;9599301;0.044596;quickSort
545600;2441035825152;283456;10168213;10451669;9601301;0.044582;quickSort
545700;2441144955152;283556;10170413;10453969;9603301;0.044655;quickSort
545800;245038352960;283656;10172613;10456269;9605301;0.044590;quickSort
545900;245147522960;283756;10174813;10458569;9607301;0.044575;quickSort
546000;245256712960;283856;10177013;10460869;9609301;0.044634;quickSort
546100;245365922960;283956;10179213;10463169;9611301;0.044566;quickSort
546200;245475152960;284056;10181413;10465469;9613301;0.044606;quickSort
546300;245584402960;284156;10183613;10467769;9615301;0.044637;quickSort
546400;245693672960;284256;10185813;10470069;9617301;0.044639;quickSort
546500;245802962960;284356;10188013;10472369;9619301;0.044692;quickSort
546600;245912272960;284456;10190213;10474669;9621301;0.044710;quickSort
546700;2451021602960;284556;10192413;10476969;9623301;0.044566;quickSort
546800;2451130952960;284656;10194613;10479269;9625301;0.044631;quickSort
546900;246024570768;284756;10196813;10481569;9627301;0.044734;quickSort
547000;246133960768;284856;10199013;10483869;9629301;0.044741;quickSort
547100;246243370768;284956;10201213;10486169;9631301;0.044732;quickSort
547200;246352800768;285056;10203413;10488469;9633301;0.044694;quickSort
547300;246462250768;285156;10205613;10490769;9635301;0.044779;quickSort
547400;246571720768;285256;10207813;10493069;9637301;0.044678;quickSort
547500;246681210768;285356;10210013;10495369;9639301;0.044719;quickSort
547600;246790720768;285456;10212213;10497669;9641301;0.044803;quickSort
547700;246900250768;285556;10214413;10499969;9643301;0.045394;quickSort
547800;2461009800768;285656;10216613;10502269;9645301;0.044958;quickSort
547900;2461119370768;285756;10218813;10504569;9647301;0.044763;quickSort
548000;247013208576;285856;10221013;10506869;9649301;0.044816;quickSort
548100;247122818576;285956;10223213;10509169;9651301;0.044976;quickSort
548200;247232448576;286056;10225413;10511469;9653301;0.044943;quickSort
548300;247342098576;286156;10227613;10513769;9655301;0.044912;quickSort
548400;247451768576;286256;10229813;10516069;9657301;0.044782;quickSort
548500;247561458576;286356;10232013;10518369;9659301;0.044897;quickSort
548600;247671168576;286456;10234213;10520669;9661301;0.044910;quickSort
548700;247780898576;286556;10236413;10522969;9663301;0.046080;quickSort
548800;247890648576;286656;10238613;10525269;9665301;0.044971;quickSort
548900;2471000418576;286756;10240813;10527569;9667301;0.044914;quickSort
549000;2471110208576;286856;10243013;10529869;9669301;0.045073;quickSort
549100;248004266384;286956;10245213;10532169;9671301;0.045781;quickSort
549200;248114096384;287056;10247413;10534469;9673301;0.046368;quickSort
549300;248223946384;287156;10249613;10536769;9675301;0.045242;quickSort
549400;248333816384;287256;10251813;10539069;9677301;0.045083;quickSort
549500;248443706384;287356;10254013;10541369;9679301;0.045162;quickSort
549600;248553616384;287456;10256213;10543669;9681301;0.045006;quickSort
549700;248663546384;287556;10258413;10545969;9683301;0.044988;quickSort
549800;248773496384;287656;10260613;10548269;9685301;0.044942;quickSort
549900;248883466384;287756;10262813;10550569;9687301;0.045001;quickSort
550000;248993456384;287856;10265013;10552869;9689301;0.046289;quickSort
550100;2481103466384;287956;10267213;10555169;9691301;0.045106;quickSort
550200;2481213496384;288056;10269413;10557469;9693301;0.045115;quickSort
550300;249107794192;288156;10271613;10559769;9695301;0.045108;quickSort
550400;249217864192;288256;10273813;10562069;9697301;0.045068;quickSort
550500;249327954192;288356;10276013;10564369;9699301;0.046075;quickSort
550600;249438064192;288456;10278213;10566669;9701301;0.045051;quickSort
550700;249548194192;288556;10280413;10568969;9703301;0.045146;quickSort
550800;249658344192;288656;10282613;10571269;9705301;0.045165;quickSort
550900;249768514192;288756;10284813;10573569;9707301;0.045144;quickSort
551000;249878704192;288856;10287013;10575869;9709301;0.045102;quickSort
551100;249988914192;288956;10289213;10578169;9711301;0.045143;quickSort
551200;2491099144192;289056;10291413;10580469;9713301;0.045191;quickSort
551300;2491209394192;289156;10293613;10582769;9715301;0.045228;quickSort
551400;250103912000;289256;10295813;10585069;9717301;0.045192;quickSort
551500;250214202000;289356;10298013;10587369;9719301;0.045168;quickSort
551600;250324512000;289456;10300213;10589669;9721301;0.045273;quickSort
551700;250434842000;289556;10302413;10591969;9723301;0.045314;quickSort
551800;250545192000;289656;10304613;10594269;9725301;0.045295;quickSort
551900;250655562000;289756;10306813;10596569;9727301;0.045210;quickSort
552000;250765952000;289856;10309013;10598869;9729301;0.045265;quickSort
552100;250876362000;289956;10311213;10601169;9731301;0.045315;quickSort
552200;250986792000;290056;10313413;10603469;9733301;0.045329;quickSort
552300;2501097242000;290156;10315613;10605769;9735301;0.045411;quickSort
552400;2501207712000;290256;10317813;10608069;9737301;0.045354;quickSort
552500;251102449808;290356;10320013;10610369;9739301;0.045414;quickSort
552600;251212959808;290456;10322213;10612669;9741301;0.045292;quickSort
552700;251323489808;290556;10324413;10614969;9743301;0.045305;quickSort
552800;251434039808;290656;10326613;10617269;9745301;0.045354;quickSort
552900;251544609808;290756;10328813;10619569;9747301;0.045510;quickSort
553000;251655199808;290856;10331013;10621869;9749301;0.045389;quickSort
553100;251765809808;290956;10333213;10624169;9751301;0.045454;quickSort
553200;251876439808;291056;10335413;10626469;9753301;0.045417;quickSort
553300;251987089808;291156;10337613;10628769;9755301;0.045474;quickSort
553400;2511097759808;291256;10339813;10631069;9757301;0.045384;quickSort
553500;2511208449808;291356;10342013;10633369;9759301;0.046511;quickSort
553600;252103407616;291456;10344213;10635669;9761301;0.045372;quickSort
553700;252214137616;291556;10346413;10637969;9763301;0.045468;quickSort
553800;252324887616;291656;10348613;10640269;9765301;0.044872;quickSort
553900;252435657616;291756;10350813;10642569;9767301;0.044857;quickSort
554000;252546447616;291856;10353013;10644869;9769301;0.045484;quickSort
554100;252657257616;291956;10355213;10647169;9771301;0.045459;quickSort
554200;252768087616;292056;10357413;10649469;9773301;0.045503;quickSort
554300;252878937616;292156;10359613;10651769;9775301;0.045504;quickSort
554400;252989807616;292256;10361813;10654069;9777301;0.045484;quickSort
554500;2521100697616;292356;10364013;10656369;9779301;0.045494;quickSort
554600;2521211607616;292456;10366213;10658669;9781301;0.045513;quickSort
554700;253106785424;292556;10368413;10660969;9783301;0.045493;quickSort
554800;253217735424;292656;10370613;10663269;9785301;0.045548;quickSort
554900;253328705424;292756;10372813;10665569;9787301;0.045483;quickSort
555000;253439695424;292856;10375013;10667869;9789301;0.045200;quickSort
555100;253550705424;292956;10377213;10670169;9791301;0.044463;quickSort
555200;253661735424;293056;10379413;10672469;9793301;0.045665;quickSort
555300;253772785424;293156;10381613;10674769;9795301;0.045580;quickSort
555400;253883855424;293256;10383813;10677069;9797301;0.045611;quickSort
555500;253994945424;293356;10386013;10679369;9799301;0.044634;quickSort
555600;2531106055424;293456;10388213;10681669;9801301;0.045616;quickSort
555700;254001433232;293556;10390413;10683969;9803301;0.045701;quickSort
555800;254112583232;293656;10392613;10686269;9805301;0.045592;quickSort
555900;254223753232;293756;10394813;10688569;9807301;0.046236;quickSort
556000;254334943232;293856;10397013;10690869;9809301;0.045946;quickSort
556100;254446153232;293956;10399213;10693169;9811301;0.045701;quickSort
556200;254557383232;294056;10401413;10695469;9813301;0.045699;quickSort
556300;254668633232;294156;10403613;10697769;9815301;0.045667;quickSort
556400;254779903232;294256;10405813;10700069;9817301;0.045636;quickSort
556500;254891193232;294356;10408013;10702369;9819301;0.045692;quickSort
556600;2541002503232;294456;10410213;10704669;9821301;0.045673;quickSort
556700;2541113833232;294556;10412413;10706969;9823301;0.045753;quickSort
556800;255009431040;294656;10414613;10709269;9825301;0.046849;quickSort
556900;255120801040;294756;10416813;10711569;9827301;0.045725;quickSort
557000;255232191040;294856;10419013;10713869;9829301;0.045710;quickSort
557100;255343601040;294956;10421213;10716169;9831301;0.046421;quickSort
557200;255455031040;295056;10423413;10718469;9833301;0.045595;quickSort
557300;255566481040;295156;10425613;10720769;9835301;0.045731;quickSort
557400;255677951040;295256;10427813;10723069;9837301;0.045729;quickSort
557500;255789441040;295356;10430013;10725369;9839301;0.045667;quickSort
557600;255900951040;295456;10432213;10727669;9841301;0.045744;quickSort
557700;2551012481040;295556;10434413;10729969;9843301;0.045708;quickSort
557800;2551124031040;295656;10436613;10732269;9845301;0.045734;quickSort
557900;256019848848;295756;10438813;10734569;9847301;0.045684;quickSort
558000;256131438848;295856;10441013;10736869;9849301;0.045744;quickSort
558100;256243048848;295956;10443213;10739169;9851301;0.045763;quickSort
558200;256354678848;296056;10445413;10741469;9853301;0.045761;quickSort
558300;256466328848;296156;10447613;10743769;9855301;0.045836;quickSort
558400;256577998848;296256;10449813;10746069;9857301;0.045858;quickSort
558500;256689688848;296356;10452013;10748369;9859301;0.045825;quickSort
558600;256801398848;296456;10454213;10750669;9861301;0.045807;quickSort
558700;256913128848;296556;10456413;10752969;9863301;0.045745;quickSort
558800;2561024878848;296656;10458613;10755269;9865301;0.045897;quickSort
558900;2561136648848;296756;10460813;10757569;9867301;0.045895;quickSort
559000;257032686656;296856;10463013;10759869;9869301;0.046117;quickSort
559100;257144496656;296956;10465213;10762169;9871301;0.045921;quickSort
559200;257256326656;297056;10467413;10764469;9873301;0.046646;quickSort
559300;257368176656;297156;10469613;10766769;9875301;0.045974;quickSort
559400;257480046656;297256;10471813;10769069;9877301;0.046859;quickSort
559500;257591936656;297356;10474013;10771369;9879301;0.045965;quickSort
559600;257703846656;297456;10476213;10773669;9881301;0.046646;quickSort
559700;257815776656;297556;10478413;10775969;9883301;0.046134;quickSort
559800;257927726656;297656;10480613;10778269;9885301;0.046521;quickSort
559900;2571039696656;297756;10482813;10780569;9887301;0.046047;quickSort
560000;2571151686656;297856;10485013;10782869;9889301;0.046404;quickSort
560100;258047944464;297956;10487213;10785169;9891301;0.045821;quickSort
560200;258159974464;298056;10489413;10787469;9893301;0.045912;quickSort
560300;258272024464;298156;10491613;10789769;9895301;0.046188;quickSort
560400;258384094464;298256;10493813;10792069;9897301;0.046344;quickSort
560500;258496184464;298356;10496013;10794369;9899301;0.046157;quickSort
560600;258608294464;298456;10498213;10796669;9901301;0.046365;quickSort
560700;258720424464;298556;10500413;10798969;9903301;0.046012;quickSort
560800;258832574464;298656;10502613;10801269;9905301;0.046075;quickSort
560900;258944744464;298756;10504813;10803569;9907301;0.046051;quickSort
561000;2581056934464;298856;10507013;10805869;9909301;0.046048;quickSort
561100;2581169144464;298956;10509213;10808169;9911301;0.045006;quickSort
561200;259065622272;299056;10511413;10810469;9913301;0.046030;quickSort
561300;259177872272;299156;10513613;10812769;9915301;0.046143;quickSort
561400;259290142272;299256;10515813;10815069;9917301;0.046071;quickSort
561500;259402432272;299356;10518013;10817369;9919301;0.046205;quickSort
561600;259514742272;299456;10520213;10819669;9921301;0.046115;quickSort
561700;259627072272;299556;10522413;10821969;9923301;0.046242;quickSort
561800;259739422272;299656;10524613;10824269;9925301;0.046195;quickSort
561900;259851792272;299756;10526813;10826569;9927301;0.046205;quickSort
562000;259964182272;299856;10529013;10828869;9929301;0.046304;quickSort
562100;2591076592272;299956;10531213;10831169;9931301;0.046371;quickSort
562200;2591189022272;300056;10533413;10833469;9933301;0.046288;quickSort
562300;260085720080;300156;10535613;10835769;9935301;0.046274;quickSort
562400;260198190080;300256;10537813;10838069;9937301;0.046357;quickSort
562500;260310680080;300356;10540013;10840369;9939301;0.046293;quickSort
562600;260423190080;300456;10542213;10842669;9941301;0.046367;quickSort
562700;260535720080;300556;10544413;10844969;9943301;0.046387;quickSort
562800;260648270080;300656;10546613;10847269;9945301;0.046380;quickSort
562900;260760840080;300756;10548813;10849569;9947301;0.046373;quickSort
563000;260873430080;300856;10551013;10851869;9949301;0.046333;quickSort
563100;260986040080;300956;10553213;10854169;9951301;0.046364;quickSort
563200;2601098670080;301056;10555413;10856469;9953301;0.046408;quickSort
563300;2601211320080;301156;10557613;10858769;9955301;0.046392;quickSort
563400;261108237888;301256;10559813;10861069;9957301;0.046489;quickSort
563500;261220927888;301356;10562013;10863369;9959301;0.046414;quickSort
563600;261333637888;301456;10564213;10865669;9961301;0.046501;quickSort
563700;261446367888;301556;10566413;10867969;9963301;0.046511;quickSort
563800;261559117888;301656;10568613;10870269;9965301;0.046434;quickSort
563900;261671887888;301756;10570813;10872569;9967301;0.046468;quickSort
564000;261784677888;301856;10573013;10874869;9969301;0.046498;quickSort
564100;261897487888;301956;10575213;10877169;9971301;0.046304;quickSort
564200;2611010317888;302056;10577413;10879469;9973301;0.046380;quickSort
564300;2611123167888;302156;10579613;10881769;9975301;0.046403;quickSort
564400;262020285696;302256;10581813;10884069;9977301;0.046476;quickSort
564500;262133175696;302356;10584013;10886369;9979301;0.046631;quickSort
564600;262246085696;302456;10586213;10888669;9981301;0.046386;quickSort
564700;262359015696;302556;10588413;10890969;9983301;0.047315;quickSort
564800;262471965696;302656;10590613;10893269;9985301;0.048531;quickSort
564900;262584935696;302756;10592813;10895569;9987301;0.046468;quickSort
565000;262697925696;302856;10595013;10897869;9989301;0.046444;quickSort
565100;262810935696;302956;10597213;10900169;9991301;0.046494;quickSort
565200;262923965696;303056;10599413;10902469;9993301;0.046446;quickSort
565300;2621037015696;303156;10601613;10904769;9995301;0.046501;quickSort
565400;2621150085696;303256;10603813;10907069;9997301;0.046470;quickSort
565500;263047423504;303356;10606013;10909369;9999301;0.047855;quickSort
565600;263160533504;303456;10608213;10911669;10001301;0.046601;quickSort
565700;263273663504;303556;10610413;10913969;10003301;0.047620;quickSort
565800;263386813504;303656;10612613;10916269;10005301;0.046593;quickSort
565900;263499983504;303756;10614813;10918569;10007301;0.046558;quickSort
566000;263613173504;303856;10617013;10920869;10009301;0.046657;quickSort
566100;263726383504;303956;10619213;10923169;10011301;0.046661;quickSort
566200;263839613504;304056;10621413;10925469;10013301;0.046934;quickSort
566300;263952863504;304156;10623613;10927769;10015301;0.046623;quickSort
566400;2631066133504;304256;10625813;10930069;10017301;0.046621;quickSort
566500;2631179423504;304356;10628013;10932369;10019301;0.046702;quickSort
566600;264076981312;304456;10630213;10934669;10021301;0.046569;quickSort
566700;264190311312;304556;10632413;10936969;10023301;0.046675;quickSort
566800;264303661312;304656;10634613;10939269;10025301;0.046684;quickSort
566900;264417031312;304756;10636813;10941569;10027301;0.046777;quickSort
567000;264530421312;304856;10639013;10943869;10029301;0.048175;quickSort
567100;264643831312;304956;10641213;10946169;10031301;0.046701;quickSort
567200;264757261312;305056;10643413;10948469;10033301;0.046716;quickSort
567300;264870711312;305156;10645613;10950769;10035301;0.046687;quickSort
567400;264984181312;305256;10647813;10953069;10037301;0.046728;quickSort
567500;2641097671312;305356;10650013;10955369;10039301;0.046751;quickSort
567600;2641211181312;305456;10652213;10957669;10041301;0.046688;quickSort
567700;265108959120;305556;10654413;10959969;10043301;0.047587;quickSort
567800;265222509120;305656;10656613;10962269;10045301;0.046905;quickSort
567900;265336079120;305756;10658813;10964569;10047301;0.046964;quickSort
568000;265449669120;305856;10661013;10966869;10049301;0.046802;quickSort
568100;265563279120;305956;10663213;10969169;10051301;0.046796;quickSort
568200;265676909120;306056;10665413;10971469;10053301;0.046720;quickSort
568300;265790559120;306156;10667613;10973769;10055301;0.046798;quickSort
568400;265904229120;306256;10669813;10976069;10057301;0.046983;quickSort
568500;2651017919120;306356;10672013;10978369;10059301;0.046736;quickSort
568600;2651131629120;306456;10674213;10980669;10061301;0.046793;quickSort
568700;266029606928;306556;10676413;10982969;10063301;0.046877;quickSort
568800;266143356928;306656;10678613;10985269;10065301;0.046904;quickSort
568900;266257126928;306756;10680813;10987569;10067301;0.046963;quickSort
569000;266370916928;306856;10683013;10989869;10069301;0.046952;quickSort
569100;266484726928;306956;10685213;10992169;10071301;0.045752;quickSort
569200;266598556928;307056;10687413;10994469;10073301;0.046816;quickSort
569300;266712406928;307156;10689613;10996769;10075301;0.046873;quickSort
569400;266826276928;307256;10691813;10999069;10077301;0.046954;quickSort
569500;266940166928;307356;10694013;11001369;10079301;0.046983;quickSort
569600;2661054076928;307456;10696213;11003669;10081301;0.046929;quickSort
569700;2661168006928;307556;10698413;11005969;10083301;0.047027;quickSort
569800;267066204736;307656;10700613;11008269;10085301;0.046955;quickSort
569900;267180174736;307756;10702813;11010569;10087301;0.047022;quickSort
570000;267294164736;307856;10705013;11012869;10089301;0.046995;quickSort
570100;267408174736;307956;10707213;11015169;10091301;0.047515;quickSort
570200;267522204736;308056;10709413;11017469;10093301;0.047888;quickSort
570300;267636254736;308156;10711613;11019769;10095301;0.047544;quickSort
570400;267750324736;308256;10713813;11022069;10097301;0.048173;quickSort
570500;267864414736;308356;10716013;11024369;10099301;0.047940;quickSort
570600;267978524736;308456;10718213;11026669;10101301;0.047050;quickSort
570700;2671092654736;308556;10720413;11028969;10103301;0.047149;quickSort
570800;2671206804736;308656;10722613;11031269;10105301;0.047040;quickSort
570900;268105222544;308756;10724813;11033569;10107301;0.047130;quickSort
571000;268219412544;308856;10727013;11035869;10109301;0.047147;quickSort
571100;268333622544;308956;10729213;11038169;10111301;0.047116;quickSort
571200;268447852544;309056;10731413;11040469;10113301;0.046191;quickSort
571300;268562102544;309156;10733613;11042769;10115301;0.047260;quickSort
571400;268676372544;309256;10735813;11045069;10117301;0.047158;quickSort
571500;268790662544;309356;10738013;11047369;10119301;0.047130;quickSort
571600;268904972544;309456;10740213;11049669;10121301;0.047122;quickSort
571700;2681019302544;309556;10742413;11051969;10123301;0.047205;quickSort
571800;2681133652544;309656;10744613;11054269;10125301;0.047383;quickSort
571900;269032270352;309756;10746813;11056569;10127301;0.047465;quickSort
572000;269146660352;309856;10749013;11058869;10129301;0.047234;quickSort
572100;269261070352;309956;10751213;11061169;10131301;0.048244;quickSort
572200;269375500352;310056;10753413;11063469;10133301;0.047231;quickSort
572300;269489950352;310156;10755613;11065769;10135301;0.047265;quickSort
572400;269604420352;310256;10757813;11068069;10137301;0.047336;quickSort
572500;269718910352;310356;10760013;11070369;10139301;0.047286;quickSort
572600;269833420352;310456;10762213;11072669;10141301;0.047368;quickSort
572700;269947950352;310556;10764413;11074969;10143301;0.047790;quickSort
572800;2691062500352;310656;10766613;11077269;10145301;0.047471;quickSort
572900;2691177070352;310756;10768813;11079569;10147301;0.047316;quickSort
573000;270075908160;310856;10771013;11081869;10149301;0.047378;quickSort
573100;270190518160;310956;10773213;11084169;10151301;0.047353;quickSort
573200;270305148160;311056;10775413;11086469;10153301;0.047367;quickSort
573300;270419798160;311156;10777613;11088769;10155301;0.047378;quickSort
573400;270534468160;311256;10779813;11091069;10157301;0.047463;quickSort
573500;270649158160;311356;10782013;11093369;10159301;0.047422;quickSort
573600;270763868160;311456;10784213;11095669;10161301;0.047384;quickSort
573700;270878598160;311556;10786413;11097969;10163301;0.047421;quickSort
573800;270993348160;311656;10788613;11100269;10165301;0.047463;quickSort
573900;2701108118160;311756;10790813;11102569;10167301;0.048587;quickSort
574000;271007155968;311856;10793013;11104869;10169301;0.047307;quickSort
574100;271121965968;311956;10795213;11107169;10171301;0.047358;quickSort
574200;271236795968;312056;10797413;11109469;10173301;0.047601;quickSort
574300;271351645968;312156;10799613;11111769;10175301;0.047841;quickSort
574400;271466515968;312256;10801813;11114069;10177301;0.047467;quickSort
574500;271581405968;312356;10804013;11116369;10179301;0.047519;quickSort
574600;271696315968;312456;10806213;11118669;10181301;0.047905;quickSort
574700;271811245968;312556;10808413;11120969;10183301;0.047704;quickSort
574800;271926195968;312656;10810613;11123269;10185301;0.047685;quickSort
574900;2711041165968;312756;10812813;11125569;10187301;0.047962;quickSort
575000;2711156155968;312856;10815013;11127869;10189301;0.047877;quickSort
575100;272055413776;312956;10817213;11130169;10191301;0.047636;quickSort
575200;272170443776;313056;10819413;11132469;10193301;0.047557;quickSort
575300;272285493776;313156;10821613;11134769;10195301;0.047548;quickSort
575400;272400563776;313256;10823813;11137069;10197301;0.049073;quickSort
575500;272515653776;313356;10826013;11139369;10199301;0.049921;quickSort
575600;272630763776;313456;10828213;11141669;10201301;0.047681;quickSort
575700;272745893776;313556;10830413;11143969;10203301;0.047589;quickSort
575800;272861043776;313656;10832613;11146269;10205301;0.047575;quickSort
575900;272976213776;313756;10834813;11148569;10207301;0.047611;quickSort
576000;2721091403776;313856;10837013;11150869;10209301;0.047594;quickSort
576100;2721206613776;313956;10839213;11153169;10211301;0.047690;quickSort
576200;273106091584;314056;10841413;11155469;10213301;0.047627;quickSort
576300;273221341584;314156;10843613;11157769;10215301;0.047680;quickSort
576400;273336611584;314256;10845813;11160069;10217301;0.047693;quickSort
576500;273451901584;314356;10848013;11162369;10219301;0.047774;quickSort
576600;273567211584;314456;10850213;11164669;10221301;0.047704;quickSort
576700;273682541584;314556;10852413;11166969;10223301;0.047817;quickSort
576800;273797891584;314656;10854613;11169269;10225301;0.047691;quickSort
576900;273913261584;314756;10856813;11171569;10227301;0.047725;quickSort
577000;2731028651584;314856;10859013;11173869;10229301;0.047785;quickSort
577100;2731144061584;314956;10861213;11176169;10231301;0.047803;quickSort
577200;274043739392;315056;10863413;11178469;10233301;0.048470;quickSort
577300;274159189392;315156;10865613;11180769;10235301;0.047860;quickSort
577400;274274659392;315256;10867813;11183069;10237301;0.047844;quickSort
577500;274390149392;315356;10870013;11185369;10239301;0.047940;quickSort
577600;274505659392;315456;10872213;11187669;10241301;0.047887;quickSort
577700;274621189392;315556;10874413;11189969;10243301;0.047964;quickSort
577800;274736739392;315656;10876613;11192269;10245301;0.048137;quickSort
577900;274852309392;315756;10878813;11194569;10247301;0.047662;quickSort
578000;274967899392;315856;10881013;11196869;10249301;0.047774;quickSort
578100;2741083509392;315956;10883213;11199169;10251301;0.048263;quickSort
578200;2741199139392;316056;10885413;11201469;10253301;0.048634;quickSort
578300;275099037200;316156;10887613;11203769;10255301;0.048338;quickSort
578400;275214707200;316256;10889813;11206069;10257301;0.047886;quickSort
578500;275330397200;316356;10892013;11208369;10259301;0.047808;quickSort
578600;275446107200;316456;10894213;11210669;10261301;0.047918;quickSort
578700;275561837200;316556;10896413;11212969;10263301;0.048103;quickSort
578800;275677587200;316656;10898613;11215269;10265301;0.047849;quickSort
578900;275793357200;316756;10900813;11217569;10267301;0.048085;quickSort
579000;275909147200;316856;10903013;11219869;10269301;0.048241;quickSort
579100;2751024957200;316956;10905213;11222169;10271301;0.048077;quickSort
579200;2751140787200;317056;10907413;11224469;10273301;0.047928;quickSort
579300;276040885008;317156;10909613;11226769;10275301;0.048065;quickSort
579400;276156755008;317256;10911813;11229069;10277301;0.048102;quickSort
579500;276272645008;317356;10914013;11231369;10279301;0.048219;quickSort
579600;276388555008;317456;10916213;11233669;10281301;0.048173;quickSort
579700;276504485008;317556;10918413;11235969;10283301;0.048845;quickSort
579800;276620435008;317656;10920613;11238269;10285301;0.047879;quickSort
579900;276736405008;317756;10922813;11240569;10287301;0.048180;quickSort
580000;276852395008;317856;10925013;11242869;10289301;0.048185;quickSort
580100;276968405008;317956;10927213;11245169;10291301;0.048221;quickSort
580200;2761084435008;318056;10929413;11247469;10293301;0.048080;quickSort
580300;2761200485008;318156;10931613;11249769;10295301;0.048138;quickSort
580400;277100802816;318256;10933813;11252069;10297301;0.047989;quickSort
580500;277216892816;318356;10936013;11254369;10299301;0.048444;quickSort
580600;277333002816;318456;10938213;11256669;10301301;0.048611;quickSort
580700;277449132816;318556;10940413;11258969;10303301;0.048248;quickSort
580800;277565282816;318656;10942613;11261269;10305301;0.048075;quickSort
580900;277681452816;318756;10944813;11263569;10307301;0.048257;quickSort
581000;277797642816;318856;10947013;11265869;10309301;0.048299;quickSort
581100;277913852816;318956;10949213;11268169;10311301;0.048065;quickSort
581200;2771030082816;319056;10951413;11270469;10313301;0.047994;quickSort
581300;2771146332816;319156;10953613;11272769;10315301;0.048159;quickSort
581400;278046850624;319256;10955813;11275069;10317301;0.048106;quickSort
581500;278163140624;319356;10958013;11277369;10319301;0.048104;quickSort
581600;278279450624;319456;10960213;11279669;10321301;0.048051;quickSort
581700;278395780624;319556;10962413;11281969;10323301;0.048019;quickSort
581800;278512130624;319656;10964613;11284269;10325301;0.048102;quickSort
581900;278628500624;319756;10966813;11286569;10327301;0.048314;quickSort
582000;278744890624;319856;10969013;11288869;10329301;0.049100;quickSort
582100;278861300624;319956;10971213;11291169;10331301;0.048206;quickSort
582200;278977730624;320056;10973413;11293469;10333301;0.048282;quickSort
582300;2781094180624;320156;10975613;11295769;10335301;0.048329;quickSort
582400;2781210650624;320256;10977813;11298069;10337301;0.048331;quickSort
582500;279111388432;320356;10980013;11300369;10339301;0.048135;quickSort
582600;279227898432;320456;10982213;11302669;10341301;0.047745;quickSort
582700;279344428432;320556;10984413;11304969;10343301;0.047833;quickSort
582800;279460978432;320656;10986613;11307269;10345301;0.048215;quickSort
582900;279577548432;320756;10988813;11309569;10347301;0.048195;quickSort
583000;279694138432;320856;10991013;11311869;10349301;0.048561;quickSort
583100;279810748432;320956;10993213;11314169;10351301;0.048285;quickSort
583200;279927378432;321056;10995413;11316469;10353301;0.048285;quickSort
583300;2791044028432;321156;10997613;11318769;10355301;0.048309;quickSort
583400;2791160698432;321256;10999813;11321069;10357301;0.048300;quickSort
583500;280061636240;321356;11002013;11323369;10359301;0.048257;quickSort
583600;280178346240;321456;11004213;11325669;10361301;0.048342;quickSort
583700;280295076240;321556;11006413;11327969;10363301;0.048315;quickSort
583800;280411826240;321656;11008613;11330269;10365301;0.048348;quickSort
583900;280528596240;321756;11010813;11332569;10367301;0.048483;quickSort
584000;280645386240;321856;11013013;11334869;10369301;0.048316;quickSort
584100;280762196240;321956;11015213;11337169;10371301;0.048239;quickSort
584200;280879026240;322056;11017413;11339469;10373301;0.048237;quickSort
584300;280995876240;322156;11019613;11341769;10375301;0.048389;quickSort
584400;2801112746240;322256;11021813;11344069;10377301;0.048304;quickSort
584500;281013884048;322356;11024013;11346369;10379301;0.048299;quickSort
584600;281130794048;322456;11026213;11348669;10381301;0.048267;quickSort
584700;281247724048;322556;11028413;11350969;10383301;0.048322;quickSort
584800;281364674048;322656;11030613;11353269;10385301;0.048401;quickSort
584900;281481644048;322756;11032813;11355569;10387301;0.048380;quickSort
585000;281598634048;322856;11035013;11357869;10389301;0.048389;quickSort
585100;281715644048;322956;11037213;11360169;10391301;0.048396;quickSort
585200;281832674048;323056;11039413;11362469;10393301;0.048364;quickSort
585300;281949724048;323156;11041613;11364769;10395301;0.048352;quickSort
585400;2811066794048;323256;11043813;11367069;10397301;0.048380;quickSort
585500;2811183884048;323356;11046013;11369369;10399301;0.048418;quickSort
585600;282085241856;323456;11048213;11371669;10401301;0.048423;quickSort
585700;282202371856;323556;11050413;11373969;10403301;0.048432;quickSort
585800;282319521856;323656;11052613;11376269;10405301;0.048362;quickSort
585900;282436691856;323756;11054813;11378569;10407301;0.050214;quickSort
586000;282553881856;323856;11057013;11380869;10409301;0.048505;quickSort
586100;282671091856;323956;11059213;11383169;10411301;0.048462;quickSort
586200;282788321856;324056;11061413;11385469;10413301;0.048513;quickSort
586300;282905571856;324156;11063613;11387769;10415301;0.048533;quickSort
586400;2821022841856;324256;11065813;11390069;10417301;0.048525;quickSort
586500;2821140131856;324356;11068013;11392369;10419301;0.048600;quickSort
586600;283041689664;324456;11070213;11394669;10421301;0.048575;quickSort
586700;283159019664;324556;11072413;11396969;10423301;0.048469;quickSort
586800;283276369664;324656;11074613;11399269;10425301;0.048437;quickSort
586900;283393739664;324756;11076813;11401569;10427301;0.049758;quickSort
587000;283511129664;324856;11079013;11403869;10429301;0.048617;quickSort
587100;283628539664;324956;11081213;11406169;10431301;0.048705;quickSort
587200;283745969664;325056;11083413;11408469;10433301;0.048655;quickSort
587300;283863419664;325156;11085613;11410769;10435301;0.048653;quickSort
587400;283980889664;325256;11087813;11413069;10437301;0.048881;quickSort
587500;2831098379664;325356;11090013;11415369;10439301;0.048672;quickSort
587600;284000137472;325456;11092213;11417669;10441301;0.048732;quickSort
587700;284117667472;325556;11094413;11419969;10443301;0.048636;quickSort
587800;284235217472;325656;11096613;11422269;10445301;0.048806;quickSort
587900;284352787472;325756;11098813;11424569;10447301;0.048815;quickSort
588000;284470377472;325856;11101013;11426869;10449301;0.048672;quickSort
588100;284587987472;325956;11103213;11429169;10451301;0.047963;quickSort
588200;284705617472;326056;11105413;11431469;10453301;0.048135;quickSort
588300;284823267472;326156;11107613;11433769;10455301;0.048792;quickSort
588400;284940937472;326256;11109813;11436069;10457301;0.048646;quickSort
588500;2841058627472;326356;11112013;11438369;10459301;0.048687;quickSort
588600;2841176337472;326456;11114213;11440669;10461301;0.048596;quickSort
588700;285078315280;326556;11116413;11442969;10463301;0.048779;quickSort
588800;285196065280;326656;11118613;11445269;10465301;0.049208;quickSort
588900;285313835280;326756;11120813;11447569;10467301;0.048732;quickSort
589000;285431625280;326856;11123013;11449869;10469301;0.048775;quickSort
589100;285549435280;326956;11125213;11452169;10471301;0.048828;quickSort
589200;285667265280;327056;11127413;11454469;10473301;0.048830;quickSort
589300;285785115280;327156;11129613;11456769;10475301;0.048769;quickSort
589400;285902985280;327256;11131813;11459069;10477301;0.048832;quickSort
589500;2851020875280;327356;11134013;11461369;10479301;0.048851;quickSort
589600;2851138785280;327456;11136213;11463669;10481301;0.048741;quickSort
589700;286040963088;327556;11138413;11465969;10483301;0.048831;quickSort
589800;286158913088;327656;11140613;11468269;10485301;0.048775;quickSort
589900;286276883088;327756;11142813;11470569;10487301;0.048891;quickSort
590000;286394873088;327856;11145013;11472869;10489301;0.048859;quickSort
590100;286512883088;327956;11147213;11475169;10491301;0.048845;quickSort
590200;286630913088;328056;11149413;11477469;10493301;0.048906;quickSort
590300;286748963088;328156;11151613;11479769;10495301;0.048865;quickSort
590400;286867033088;328256;11153813;11482069;10497301;0.048916;quickSort
590500;286985123088;328356;11156013;11484369;10499301;0.048892;quickSort
590600;2861103233088;328456;11158213;11486669;10501301;0.048906;quickSort
590700;287005610896;328556;11160413;11488969;10503301;0.048896;quickSort
590800;287123760896;328656;11162613;11491269;10505301;0.049548;quickSort
590900;287241930896;328756;11164813;11493569;10507301;0.048934;quickSort
591000;287360120896;328856;11167013;11495869;10509301;0.048905;quickSort
591100;287478330896;328956;11169213;11498169;10511301;0.049018;quickSort
591200;287596560896;329056;11171413;11500469;10513301;0.049809;quickSort
591300;287714810896;329156;11173613;11502769;10515301;0.048985;quickSort
591400;287833080896;329256;11175813;11505069;10517301;0.048942;quickSort
591500;287951370896;329356;11178013;11507369;10519301;0.048979;quickSort
591600;2871069680896;329456;11180213;11509669;10521301;0.049067;quickSort
591700;2871188010896;329556;11182413;11511969;10523301;0.049263;quickSort
591800;288090608704;329656;11184613;11514269;10525301;0.050741;quickSort
591900;288208978704;329756;11186813;11516569;10527301;0.049218;quickSort
592000;288327368704;329856;11189013;11518869;10529301;0.049132;quickSort
592100;288445778704;329956;11191213;11521169;10531301;0.049184;quickSort
592200;288564208704;330056;11193413;11523469;10533301;0.050189;quickSort
592300;288682658704;330156;11195613;11525769;10535301;0.049039;quickSort
592400;288801128704;330256;11197813;11528069;10537301;0.049076;quickSort
592500;288919618704;330356;11200013;11530369;10539301;0.049053;quickSort
592600;2881038128704;330456;11202213;11532669;10541301;0.049081;quickSort
592700;2881156658704;330556;11204413;11534969;10543301;0.049074;quickSort
592800;289059456512;330656;11206613;11537269;10545301;0.049102;quickSort
592900;289178026512;330756;11208813;11539569;10547301;0.049111;quickSort
593000;289296616512;330856;11211013;11541869;10549301;0.047878;quickSort
593100;289415226512;330956;11213213;11544169;10551301;0.049170;quickSort
593200;289533856512;331056;11215413;11546469;10553301;0.049271;quickSort
593300;289652506512;331156;11217613;11548769;10555301;0.049178;quickSort
593400;289771176512;331256;11219813;11551069;10557301;0.049274;quickSort
593500;289889866512;331356;11222013;11553369;10559301;0.049228;quickSort
593600;2891008576512;331456;11224213;11555669;10561301;0.049155;quickSort
593700;2891127306512;331556;11226413;11557969;10563301;0.049220;quickSort
593800;290030304320;331656;11228613;11560269;10565301;0.049207;quickSort
593900;290149074320;331756;11230813;11562569;10567301;0.049281;quickSort
594000;290267864320;331856;11233013;11564869;10569301;0.050354;quickSort
594100;290386674320;331956;11235213;11567169;10571301;0.049265;quickSort
594200;290505504320;332056;11237413;11569469;10573301;0.049328;quickSort
594300;290624354320;332156;11239613;11571769;10575301;0.049421;quickSort
594400;290743224320;332256;11241813;11574069;10577301;0.049379;quickSort
594500;290862114320;332356;11244013;11576369;10579301;0.049428;quickSort
594600;290981024320;332456;11246213;11578669;10581301;0.049387;quickSort
594700;2901099954320;332556;11248413;11580969;10583301;0.050121;quickSort
594800;291003152128;332656;11250613;11583269;10585301;0.049438;quickSort
594900;291122122128;332756;11252813;11585569;10587301;0.049446;quickSort
595000;291241112128;332856;11255013;11587869;10589301;0.049508;quickSort
595100;291360122128;332956;11257213;11590169;10591301;0.050878;quickSort
595200;291479152128;333056;11259413;11592469;10593301;0.049375;quickSort
595300;291598202128;333156;11261613;11594769;10595301;0.049412;quickSort
595400;291717272128;333256;11263813;11597069;10597301;0.049435;quickSort
595500;291836362128;333356;11266013;11599369;10599301;0.049486;quickSort
595600;291955472128;333456;11268213;11601669;10601301;0.049455;quickSort
595700;2911074602128;333556;11270413;11603969;10603301;0.049572;quickSort
595800;2911193752128;333656;11272613;11606269;10605301;0.049600;quickSort
595900;292097169936;333756;11274813;11608569;10607301;0.049458;quickSort
596000;292216359936;333856;11277013;11610869;10609301;0.049509;quickSort
596100;292335569936;333956;11279213;11613169;10611301;0.049542;quickSort
596200;292454799936;334056;11281413;11615469;10613301;0.049616;quickSort
596300;292574049936;334156;11283613;11617769;10615301;0.049635;quickSort
596400;292693319936;334256;11285813;11620069;10617301;0.049553;quickSort
596500;292812609936;334356;11288013;11622369;10619301;0.048946;quickSort
596600;292931919936;334456;11290213;11624669;10621301;0.049607;quickSort
596700;2921051249936;334556;11292413;11626969;10623301;0.049553;quickSort
596800;2921170599936;334656;11294613;11629269;10625301;0.048734;quickSort
596900;293074217744;334756;11296813;11631569;10627301;0.049637;quickSort
597000;293193607744;334856;11299013;11633869;10629301;0.050033;quickSort
597100;293313017744;334956;11301213;11636169;10631301;0.049647;quickSort
597200;293432447744;335056;11303413;11638469;10633301;0.049775;quickSort
597300;293551897744;335156;11305613;11640769;10635301;0.049646;quickSort
597400;293671367744;335256;11307813;11643069;10637301;0.050117;quickSort
597500;293790857744;335356;11310013;11645369;10639301;0.049709;quickSort
597600;293910367744;335456;11312213;11647669;10641301;0.049636;quickSort
597700;2931029897744;335556;11314413;11649969;10643301;0.049935;quickSort
597800;2931149447744;335656;11316613;11652269;10645301;0.049967;quickSort
597900;294053265552;335756;11318813;11654569;10647301;0.049608;quickSort
598000;294172855552;335856;11321013;11656869;10649301;0.049721;quickSort
598100;294292465552;335956;11323213;11659169;10651301;0.049628;quickSort
598200;294412095552;336056;11325413;11661469;10653301;0.049397;quickSort
598300;294531745552;336156;11327613;11663769;10655301;0.048719;quickSort
598400;294651415552;336256;11329813;11666069;10657301;0.049665;quickSort
598500;294771105552;336356;11332013;11668369;10659301;0.049838;quickSort
598600;294890815552;336456;11334213;11670669;10661301;0.049813;quickSort
598700;2941010545552;336556;11336413;11672969;10663301;0.049778;quickSort
598800;2941130295552;336656;11338613;11675269;10665301;0.049834;quickSort
598900;295034313360;336756;11340813;11677569;10667301;0.049889;quickSort
599000;295154103360;336856;11343013;11679869;10669301;0.049819;quickSort
599100;295273913360;336956;11345213;11682169;10671301;0.049879;quickSort
599200;295393743360;337056;11347413;11684469;10673301;0.049830;quickSort
599300;295513593360;337156;11349613;11686769;10675301;0.049866;quickSort
599400;295633463360;337256;11351813;11689069;10677301;0.049920;quickSort
599500;295753353360;337356;11354013;11691369;10679301;0.049855;quickSort
599600;295873263360;337456;11356213;11693669;10681301;0.049916;quickSort
599700;295993193360;337556;11358413;11695969;10683301;0.049915;quickSort
599800;2951113143360;337656;11360613;11698269;10685301;0.049920;quickSort
599900;296017361168;337756;11362813;11700569;10687301;0.049968;quickSort
600000;296137351168;337856;11365013;11702869;10689301;0.049919;quickSort
600100;296257361168;337956;11367213;11705169;10691301;0.050062;quickSort
600200;296377391168;338056;11369413;11707469;10693301;0.049935;quickSort
600300;296497441168;338156;11371613;11709769;10695301;0.050012;quickSort
600400;296617511168;338256;11373813;11712069;10697301;0.048836;quickSort
600500;296737601168;338356;11376013;11714369;10699301;0.050130;quickSort
600600;296857711168;338456;11378213;11716669;10701301;0.050002;quickSort
600700;296977841168;338556;11380413;11718969;10703301;0.050092;quickSort
600800;2961097991168;338656;11382613;11721269;10705301;0.050144;quickSort
600900;297002408976;338756;11384813;11723569;10707301;0.049686;quickSort
601000;297122598976;338856;11387013;11725869;10709301;0.049474;quickSort
601100;297242808976;338956;11389213;11728169;10711301;0.050226;quickSort
601200;297363038976;339056;11391413;11730469;10713301;0.050177;quickSort
601300;297483288976;339156;11393613;11732769;10715301;0.049670;quickSort
601400;297603558976;339256;11395813;11735069;10717301;0.050299;quickSort
601500;297723848976;339356;11398013;11737369;10719301;0.050310;quickSort
601600;297844158976;339456;11400213;11739669;10721301;0.050308;quickSort
601700;297964488976;339556;11402413;11741969;10723301;0.050234;quickSort
601800;2971084838976;339656;11404613;11744269;10725301;0.050956;quickSort
601900;2971205208976;339756;11406813;11746569;10727301;0.051818;quickSort
602000;298109846784;339856;11409013;11748869;10729301;0.050232;quickSort
602100;298230256784;339956;11411213;11751169;10731301;0.050375;quickSort
602200;298350686784;340056;11413413;11753469;10733301;0.050452;quickSort
602300;298471136784;340156;11415613;11755769;10735301;0.051374;quickSort
602400;298591606784;340256;11417813;11758069;10737301;0.050236;quickSort
602500;298712096784;340356;11420013;11760369;10739301;0.049196;quickSort
602600;298832606784;340456;11422213;11762669;10741301;0.052546;quickSort
602700;298953136784;340556;11424413;11764969;10743301;0.050186;quickSort
602800;2981073686784;340656;11426613;11767269;10745301;0.050206;quickSort
602900;2981194256784;340756;11428813;11769569;10747301;0.050276;quickSort
603000;299099094592;340856;11431013;11771869;10749301;0.050308;quickSort
603100;299219704592;340956;11433213;11774169;10751301;0.050303;quickSort
603200;299340334592;341056;11435413;11776469;10753301;0.050290;quickSort
603300;299460984592;341156;11437613;11778769;10755301;0.050334;quickSort
603400;299581654592;341256;11439813;11781069;10757301;0.050307;quickSort
603500;299702344592;341356;11442013;11783369;10759301;0.050533;quickSort
603600;299823054592;341456;11444213;11785669;10761301;0.050581;quickSort
603700;299943784592;341556;11446413;11787969;10763301;0.052482;quickSort
603800;2991064534592;341656;11448613;11790269;10765301;0.050370;quickSort
603900;2991185304592;341756;11450813;11792569;10767301;0.050392;quickSort
604000;300090342400;341856;11453013;11794869;10769301;0.050354;quickSort
604100;300211152400;341956;11455213;11797169;10771301;0.050937;quickSort
604200;300331982400;342056;11457413;11799469;10773301;0.051507;quickSort
604300;300452832400;342156;11459613;11801769;10775301;0.050471;quickSort
604400;300573702400;342256;11461813;11804069;10777301;0.050456;quickSort
604500;300694592400;342356;11464013;11806369;10779301;0.051185;quickSort
604600;300815502400;342456;11466213;11808669;10781301;0.051203;quickSort
604700;300936432400;342556;11468413;11810969;10783301;0.050400;quickSort
604800;3001057382400;342656;11470613;11813269;10785301;0.050448;quickSort
604900;3001178352400;342756;11472813;11815569;10787301;0.050528;quickSort
605000;301083590208;342856;11475013;11817869;10789301;0.050449;quickSort
605100;301204600208;342956;11477213;11820169;10791301;0.050472;quickSort
605200;301325630208;343056;11479413;11822469;10793301;0.050411;quickSort
605300;301446680208;343156;11481613;11824769;10795301;0.050485;quickSort
605400;301567750208;343256;11483813;11827069;10797301;0.051798;quickSort
605500;301688840208;343356;11486013;11829369;10799301;0.050520;quickSort
605600;301809950208;343456;11488213;11831669;10801301;0.050553;quickSort
605700;301931080208;343556;11490413;11833969;10803301;0.050598;quickSort
605800;3011052230208;343656;11492613;11836269;10805301;0.050528;quickSort
605900;3011173400208;343756;11494813;11838569;10807301;0.051242;quickSort
606000;302078838016;343856;11497013;11840869;10809301;0.050977;quickSort
606100;302200048016;343956;11499213;11843169;10811301;0.050665;quickSort
606200;302321278016;344056;11501413;11845469;10813301;0.050848;quickSort
606300;302442528016;344156;11503613;11847769;10815301;0.050895;quickSort
606400;302563798016;344256;11505813;11850069;10817301;0.051096;quickSort
606500;302685088016;344356;11508013;11852369;10819301;0.051091;quickSort
606600;302806398016;344456;11510213;11854669;10821301;0.050893;quickSort
606700;302927728016;344556;11512413;11856969;10823301;0.050771;quickSort
606800;3021049078016;344656;11514613;11859269;10825301;0.050904;quickSort
606900;3021170448016;344756;11516813;11861569;10827301;0.050765;quickSort
607000;303076085824;344856;11519013;11863869;10829301;0.051454;quickSort
607100;303197495824;344956;11521213;11866169;10831301;0.050784;quickSort
607200;303318925824;345056;11523413;11868469;10833301;0.051174;quickSort
607300;303440375824;345156;11525613;11870769;10835301;0.051265;quickSort
607400;303561845824;345256;11527813;11873069;10837301;0.050820;quickSort
607500;303683335824;345356;11530013;11875369;10839301;0.051746;quickSort
607600;303804845824;345456;11532213;11877669;10841301;0.052942;quickSort
607700;303926375824;345556;11534413;11879969;10843301;0.054290;quickSort
607800;3031047925824;345656;11536613;11882269;10845301;0.052863;quickSort
607900;3031169495824;345756;11538813;11884569;10847301;0.051248;quickSort
608000;304075333632;345856;11541013;11886869;10849301;0.050997;quickSort
608100;304196943632;345956;11543213;11889169;10851301;0.051747;quickSort
608200;304318573632;346056;11545413;11891469;10853301;0.052398;quickSort
608300;304440223632;346156;11547613;11893769;10855301;0.051878;quickSort
608400;304561893632;346256;11549813;11896069;10857301;0.051809;quickSort
608500;304683583632;346356;11552013;11898369;10859301;0.052082;quickSort
608600;304805293632;346456;11554213;11900669;10861301;0.050998;quickSort
608700;304927023632;346556;11556413;11902969;10863301;0.052427;quickSort
608800;3041048773632;346656;11558613;11905269;10865301;0.051055;quickSort
608900;3041170543632;346756;11560813;11907569;10867301;0.051585;quickSort
609000;305076581440;346856;11563013;11909869;10869301;0.050914;quickSort
609100;305198391440;346956;11565213;11912169;10871301;0.050977;quickSort
609200;305320221440;347056;11567413;11914469;10873301;0.051205;quickSort
609300;305442071440;347156;11569613;11916769;10875301;0.051029;quickSort
609400;305563941440;347256;11571813;11919069;10877301;0.050947;quickSort
609500;305685831440;347356;11574013;11921369;10879301;0.050941;quickSort
609600;305807741440;347456;11576213;11923669;10881301;0.050904;quickSort
609700;305929671440;347556;11578413;11925969;10883301;0.051349;quickSort
609800;3051051621440;347656;11580613;11928269;10885301;0.052998;quickSort
609900;3051173591440;347756;11582813;11930569;10887301;0.054591;quickSort
610000;306079829248;347856;11585013;11932869;10889301;0.053167;quickSort
610100;306201839248;347956;11587213;11935169;10891301;0.051711;quickSort
610200;306323869248;348056;11589413;11937469;10893301;0.052506;quickSort
610300;306445919248;348156;11591613;11939769;10895301;0.051048;quickSort
610400;306567989248;348256;11593813;11942069;10897301;0.051248;quickSort
610500;306690079248;348356;11596013;11944369;10899301;0.051051;quickSort
610600;306812189248;348456;11598213;11946669;10901301;0.060013;quickSort
610700;306934319248;348556;11600413;11948969;10903301;0.051072;quickSort
610800;3061056469248;348656;11602613;11951269;10905301;0.051480;quickSort
610900;3061178639248;348756;11604813;11953569;10907301;0.051206;quickSort
611000;307085077056;348856;11607013;11955869;10909301;0.051000;quickSort
611100;307207287056;348956;11609213;11958169;10911301;0.051113;quickSort
611200;307329517056;349056;11611413;11960469;10913301;0.051134;quickSort
611300;307451767056;349156;11613613;11962769;10915301;0.051179;quickSort
611400;307574037056;349256;11615813;11965069;10917301;0.051160;quickSort
611500;307696327056;349356;11618013;11967369;10919301;0.051673;quickSort
611600;307818637056;349456;11620213;11969669;10921301;0.049948;quickSort
611700;307940967056;349556;11622413;11971969;10923301;0.051129;quickSort
611800;3071063317056;349656;11624613;11974269;10925301;0.051123;quickSort
611900;3071185687056;349756;11626813;11976569;10927301;0.051336;quickSort
612000;308092324864;349856;11629013;11978869;10929301;0.051811;quickSort
612100;308214734864;349956;11631213;11981169;10931301;0.051748;quickSort
612200;308337164864;350056;11633413;11983469;10933301;0.051404;quickSort
612300;308459614864;350156;11635613;11985769;10935301;0.051335;quickSort
612400;308582084864;350256;11637813;11988069;10937301;0.051366;quickSort
612500;308704574864;350356;11640013;11990369;10939301;0.051507;quickSort
612600;308827084864;350456;11642213;11992669;10941301;0.055035;quickSort
612700;308949614864;350556;11644413;11994969;10943301;0.054673;quickSort
612800;3081072164864;350656;11646613;11997269;10945301;0.053613;quickSort
612900;3081194734864;350756;11648813;11999569;10947301;0.051254;quickSort
613000;309101572672;350856;11651013;12001869;10949301;0.051246;quickSort
613100;309224182672;350956;11653213;12004169;10951301;0.051248;quickSort
613200;309346812672;351056;11655413;12006469;10953301;0.051255;quickSort
613300;309469462672;351156;11657613;12008769;10955301;0.051247;quickSort
613400;309592132672;351256;11659813;12011069;10957301;0.051914;quickSort
613500;309714822672;351356;11662013;12013369;10959301;0.051355;quickSort
613600;309837532672;351456;11664213;12015669;10961301;0.051357;quickSort
613700;309960262672;351556;11666413;12017969;10963301;0.051403;quickSort
613800;3091083012672;351656;11668613;12020269;10965301;0.051583;quickSort
613900;3091205782672;351756;11670813;12022569;10967301;0.051472;quickSort
614000;310112820480;351856;11673013;12024869;10969301;0.051462;quickSort
614100;310235630480;351956;11675213;12027169;10971301;0.050520;quickSort
614200;310358460480;352056;11677413;12029469;10973301;0.051741;quickSort
614300;310481310480;352156;11679613;12031769;10975301;0.051466;quickSort
614400;310604180480;352256;11681813;12034069;10977301;0.051425;quickSort
614500;310727070480;352356;11684013;12036369;10979301;0.051641;quickSort
614600;310849980480;352456;11686213;12038669;10981301;0.051467;quickSort
614700;310972910480;352556;11688413;12040969;10983301;0.051382;quickSort
614800;3101095860480;352656;11690613;12043269;10985301;0.051386;quickSort
614900;311003078288;352756;11692813;12045569;10987301;0.051786;quickSort
615000;311126068288;352856;11695013;12047869;10989301;0.051602;quickSort
615100;311249078288;352956;11697213;12050169;10991301;0.052082;quickSort
615200;311372108288;353056;11699413;12052469;10993301;0.051701;quickSort
615300;311495158288;353156;11701613;12054769;10995301;0.051569;quickSort
615400;311618228288;353256;11703813;12057069;10997301;0.051922;quickSort
615500;311741318288;353356;11706013;12059369;10999301;0.051764;quickSort
615600;311864428288;353456;11708213;12061669;11001301;0.051993;quickSort
615700;311987558288;353556;11710413;12063969;11003301;0.052220;quickSort
615800;3111110708288;353656;11712613;12066269;11005301;0.051904;quickSort
615900;312018126096;353756;11714813;12068569;11007301;0.051988;quickSort
616000;312141316096;353856;11717013;12070869;11009301;0.052108;quickSort
616100;312264526096;353956;11719213;12073169;11011301;0.051564;quickSort
616200;312387756096;354056;11721413;12075469;11013301;0.051580;quickSort
616300;312511006096;354156;11723613;12077769;11015301;0.051675;quickSort
616400;312634276096;354256;11725813;12080069;11017301;0.051737;quickSort
616500;312757566096;354356;11728013;12082369;11019301;0.051674;quickSort
616600;312880876096;354456;11730213;12084669;11021301;0.051609;quickSort
616700;3121004206096;354556;11732413;12086969;11023301;0.051654;quickSort
616800;3121127556096;354656;11734613;12089269;11025301;0.051625;quickSort
616900;313035173904;354756;11736813;12091569;11027301;0.051829;quickSort
617000;313158563904;354856;11739013;12093869;11029301;0.052518;quickSort
617100;313281973904;354956;11741213;12096169;11031301;0.051704;quickSort
617200;313405403904;355056;11743413;12098469;11033301;0.051713;quickSort
617300;313528853904;355156;11745613;12100769;11035301;0.051662;quickSort
617400;313652323904;355256;11747813;12103069;11037301;0.051805;quickSort
617500;313775813904;355356;11750013;12105369;11039301;0.051721;quickSort
617600;313899323904;355456;11752213;12107669;11041301;0.051775;quickSort
617700;3131022853904;355556;11754413;12109969;11043301;0.051691;quickSort
617800;3131146403904;355656;11756613;12112269;11045301;0.051692;quickSort
617900;314054221712;355756;11758813;12114569;11047301;0.051896;quickSort
618000;314177811712;355856;11761013;12116869;11049301;0.051699;quickSort
618100;314301421712;355956;11763213;12119169;11051301;0.051737;quickSort
618200;314425051712;356056;11765413;12121469;11053301;0.051770;quickSort
618300;314548701712;356156;11767613;12123769;11055301;0.051751;quickSort
618400;314672371712;356256;11769813;12126069;11057301;0.051882;quickSort
618500;314796061712;356356;11772013;12128369;11059301;0.051859;quickSort
618600;314919771712;356456;11774213;12130669;11061301;0.051920;quickSort
618700;3141043501712;356556;11776413;12132969;11063301;0.051811;quickSort
618800;3141167251712;356656;11778613;12135269;11065301;0.051884;quickSort
618900;315075269520;356756;11780813;12137569;11067301;0.051779;quickSort
619000;315199059520;356856;11783013;12139869;11069301;0.051918;quickSort
619100;315322869520;356956;11785213;12142169;11071301;0.051881;quickSort
619200;315446699520;357056;11787413;12144469;11073301;0.051850;quickSort
619300;315570549520;357156;11789613;12146769;11075301;0.051879;quickSort
619400;315694419520;357256;11791813;12149069;11077301;0.052027;quickSort
619500;315818309520;357356;11794013;12151369;11079301;0.052717;quickSort
619600;315942219520;357456;11796213;12153669;11081301;0.051353;quickSort
619700;3151066149520;357556;11798413;12155969;11083301;0.052037;quickSort
619800;3151190099520;357656;11800613;12158269;11085301;0.052038;quickSort
619900;316098317328;357756;11802813;12160569;11087301;0.052966;quickSort
620000;316222307328;357856;11805013;12162869;11089301;0.051906;quickSort
620100;316346317328;357956;11807213;12165169;11091301;0.052747;quickSort
620200;316470347328;358056;11809413;12167469;11093301;0.051940;quickSort
620300;316594397328;358156;11811613;12169769;11095301;0.052428;quickSort
620400;316718467328;358256;11813813;12172069;11097301;0.054460;quickSort
620500;316842557328;358356;11816013;12174369;11099301;0.051945;quickSort
620600;316966667328;358456;11818213;12176669;11101301;0.052035;quickSort
620700;3161090797328;358556;11820413;12178969;11103301;0.052094;quickSort
620800;3161214947328;358656;11822613;12181269;11105301;0.052073;quickSort
620900;317123365136;358756;11824813;12183569;11107301;0.052147;quickSort
621000;317247555136;358856;11827013;12185869;11109301;0.052255;quickSort
621100;317371765136;358956;11829213;12188169;11111301;0.052877;quickSort
621200;317495995136;359056;11831413;12190469;11113301;0.052440;quickSort
621300;317620245136;359156;11833613;12192769;11115301;0.052028;quickSort
621400;317744515136;359256;11835813;12195069;11117301;0.052091;quickSort
621500;317868805136;359356;11838013;12197369;11119301;0.052172;quickSort
621600;317993115136;359456;11840213;12199669;11121301;0.052075;quickSort
621700;3171117445136;359556;11842413;12201969;11123301;0.052193;quickSort
621800;318026042944;359656;11844613;12204269;11125301;0.052282;quickSort
621900;318150412944;359756;11846813;12206569;11127301;0.052099;quickSort
622000;318274802944;359856;11849013;12208869;11129301;0.052169;quickSort
622100;318399212944;359956;11851213;12211169;11131301;0.052025;quickSort
622200;318523642944;360056;11853413;12213469;11133301;0.052625;quickSort
622300;318648092944;360156;11855613;12215769;11135301;0.052154;quickSort
622400;318772562944;360256;11857813;12218069;11137301;0.052327;quickSort
622500;318897052944;360356;11860013;12220369;11139301;0.052221;quickSort
622600;3181021562944;360456;11862213;12222669;11141301;0.052129;quickSort
622700;3181146092944;360556;11864413;12224969;11143301;0.052719;quickSort
622800;319054890752;360656;11866613;12227269;11145301;0.052235;quickSort
622900;319179460752;360756;11868813;12229569;11147301;0.052276;quickSort
623000;319304050752;360856;11871013;12231869;11149301;0.059318;quickSort
623100;319428660752;360956;11873213;12234169;11151301;0.053885;quickSort
623200;319553290752;361056;11875413;12236469;11153301;0.052383;quickSort
623300;319677940752;361156;11877613;12238769;11155301;0.055720;quickSort
623400;319802610752;361256;11879813;12241069;11157301;0.052474;quickSort
623500;319927300752;361356;11882013;12243369;11159301;0.054952;quickSort
623600;3191052010752;361456;11884213;12245669;11161301;0.052872;quickSort
623700;3191176740752;361556;11886413;12247969;11163301;0.053056;quickSort
623800;320085738560;361656;11888613;12250269;11165301;0.052461;quickSort
623900;320210508560;361756;11890813;12252569;11167301;0.052318;quickSort
624000;320335298560;361856;11893013;12254869;11169301;0.052521;quickSort
624100;320460108560;361956;11895213;12257169;11171301;0.052607;quickSort
624200;320584938560;362056;11897413;12259469;11173301;0.053444;quickSort
624300;320709788560;362156;11899613;12261769;11175301;0.052558;quickSort
624400;320834658560;362256;11901813;12264069;11177301;0.053770;quickSort
624500;320959548560;362356;11904013;12266369;11179301;0.052375;quickSort
624600;3201084458560;362456;11906213;12268669;11181301;0.053119;quickSort
624700;3201209388560;362556;11908413;12270969;11183301;0.052462;quickSort
624800;321118586368;362656;11910613;12273269;11185301;0.052615;quickSort
624900;321243556368;362756;11912813;12275569;11187301;0.052444;quickSort
625000;321368546368;362856;11915013;12277869;11189301;0.052412;quickSort
625100;321493556368;362956;11917213;12280169;11191301;0.052403;quickSort
625200;321618586368;363056;11919413;12282469;11193301;0.052472;quickSort
625300;321743636368;363156;11921613;12284769;11195301;0.052536;quickSort
625400;321868706368;363256;11923813;12287069;11197301;0.052486;quickSort
625500;321993796368;363356;11926013;12289369;11199301;0.052661;quickSort
625600;3211118906368;363456;11928213;12291669;11201301;0.052441;quickSort
625700;322028284176;363556;11930413;12293969;11203301;0.052719;quickSort
625800;322153434176;363656;11932613;12296269;11205301;0.053365;quickSort
625900;322278604176;363756;11934813;12298569;11207301;0.052572;quickSort
626000;322403794176;363856;11937013;12300869;11209301;0.053165;quickSort
626100;322529004176;363956;11939213;12303169;11211301;0.053379;quickSort
626200;322654234176;364056;11941413;12305469;11213301;0.052703;quickSort
626300;322779484176;364156;11943613;12307769;11215301;0.053099;quickSort
626400;322904754176;364256;11945813;12310069;11217301;0.053911;quickSort
626500;3221030044176;364356;11948013;12312369;11219301;0.053384;quickSort
626600;3221155354176;364456;11950213;12314669;11221301;0.052690;quickSort
626700;323064931984;364556;11952413;12316969;11223301;0.052686;quickSort
626800;323190281984;364656;11954613;12319269;11225301;0.052679;quickSort
626900;323315651984;364756;11956813;12321569;11227301;0.052591;quickSort
627000;323441041984;364856;11959013;12323869;11229301;0.052715;quickSort
627100;323566451984;364956;11961213;12326169;11231301;0.053644;quickSort
627200;323691881984;365056;11963413;12328469;11233301;0.052942;quickSort
627300;323817331984;365156;11965613;12330769;11235301;0.052747;quickSort
627400;323942801984;365256;11967813;12333069;11237301;0.052682;quickSort
627500;3231068291984;365356;11970013;12335369;11239301;0.052754;quickSort
627600;3231193801984;365456;11972213;12337669;11241301;0.052683;quickSort
627700;324103579792;365556;11974413;12339969;11243301;0.052926;quickSort
627800;324229129792;365656;11976613;12342269;11245301;0.052868;quickSort
627900;324354699792;365756;11978813;12344569;11247301;0.052862;quickSort
628000;324480289792;365856;11981013;12346869;11249301;0.052302;quickSort
628100;324605899792;365956;11983213;12349169;11251301;0.051931;quickSort
628200;324731529792;366056;11985413;12351469;11253301;0.052935;quickSort
628300;324857179792;366156;11987613;12353769;11255301;0.052726;quickSort
628400;324982849792;366256;11989813;12356069;11257301;0.052778;quickSort
628500;3241108539792;366356;11992013;12358369;11259301;0.052825;quickSort
628600;325018497600;366456;11994213;12360669;11261301;0.052817;quickSort
628700;325144227600;366556;11996413;12362969;11263301;0.052831;quickSort
628800;325269977600;366656;11998613;12365269;11265301;0.051670;quickSort
628900;325395747600;366756;12000813;12367569;11267301;0.052884;quickSort
629000;325521537600;366856;12003013;12369869;11269301;0.052912;quickSort
629100;325647347600;366956;12005213;12372169;11271301;0.052858;quickSort
629200;325773177600;367056;12007413;12374469;11273301;0.054027;quickSort
629300;325899027600;367156;12009613;12376769;11275301;0.052979;quickSort
629400;3251024897600;367256;12011813;12379069;11277301;0.052927;quickSort
629500;3251150787600;367356;12014013;12381369;11279301;0.052995;quickSort
629600;326060945408;367456;12016213;12383669;11281301;0.053020;quickSort
629700;326186875408;367556;12018413;12385969;11283301;0.052996;quickSort
629800;326312825408;367656;12020613;12388269;11285301;0.053237;quickSort
629900;326438795408;367756;12022813;12390569;11287301;0.053491;quickSort
630000;326564785408;367856;12025013;12392869;11289301;0.053267;quickSort
630100;326690795408;367956;12027213;12395169;11291301;0.053426;quickSort
630200;326816825408;368056;12029413;12397469;11293301;0.053275;quickSort
630300;326942875408;368156;12031613;12399769;11295301;0.053157;quickSort
630400;3261068945408;368256;12033813;12402069;11297301;0.053473;quickSort
630500;3261195035408;368356;12036013;12404369;11299301;0.053148;quickSort
630600;327105393216;368456;12038213;12406669;11301301;0.052285;quickSort
630700;327231523216;368556;12040413;12408969;11303301;0.051968;quickSort
630800;327357673216;368656;12042613;12411269;11305301;0.053140;quickSort
630900;327483843216;368756;12044813;12413569;11307301;0.053026;quickSort
631000;327610033216;368856;12047013;12415869;11309301;0.055998;quickSort
631100;327736243216;368956;12049213;12418169;11311301;0.053175;quickSort
631200;327862473216;369056;12051413;12420469;11313301;0.051837;quickSort
631300;327988723216;369156;12053613;12422769;11315301;0.053101;quickSort
631400;3271114993216;369256;12055813;12425069;11317301;0.053080;quickSort
631500;328025531024;369356;12058013;12427369;11319301;0.053171;quickSort
631600;328151841024;369456;12060213;12429669;11321301;0.051881;quickSort
631700;328278171024;369556;12062413;12431969;11323301;0.053120;quickSort
631800;328404521024;369656;12064613;12434269;11325301;0.051935;quickSort
631900;328530891024;369756;12066813;12436569;11327301;0.053238;quickSort
632000;328657281024;369856;12069013;12438869;11329301;0.053181;quickSort
632100;328783691024;369956;12071213;12441169;11331301;0.053225;quickSort
632200;328910121024;370056;12073413;12443469;11333301;0.053320;quickSort
632300;3281036571024;370156;12075613;12445769;11335301;0.053364;quickSort
632400;3281163041024;370256;12077813;12448069;11337301;0.053214;quickSort
632500;329073778832;370356;12080013;12450369;11339301;0.053213;quickSort
632600;329200288832;370456;12082213;12452669;11341301;0.052066;quickSort
632700;329326818832;370556;12084413;12454969;11343301;0.053236;quickSort
632800;329453368832;370656;12086613;12457269;11345301;0.053273;quickSort
632900;329579938832;370756;12088813;12459569;11347301;0.052330;quickSort
633000;329706528832;370856;12091013;12461869;11349301;0.054493;quickSort
633100;329833138832;370956;12093213;12464169;11351301;0.053375;quickSort
633200;329959768832;371056;12095413;12466469;11353301;0.053363;quickSort
633300;3291086418832;371156;12097613;12468769;11355301;0.052625;quickSort
633400;3291213088832;371256;12099813;12471069;11357301;0.053636;quickSort
633500;330124026640;371356;12102013;12473369;11359301;0.052591;quickSort
633600;330250736640;371456;12104213;12475669;11361301;0.053140;quickSort
633700;330377466640;371556;12106413;12477969;11363301;0.053860;quickSort
633800;330504216640;371656;12108613;12480269;11365301;0.053470;quickSort
633900;330630986640;371756;12110813;12482569;11367301;0.053480;quickSort
634000;330757776640;371856;12113013;12484869;11369301;0.054439;quickSort
634100;330884586640;371956;12115213;12487169;11371301;0.053406;quickSort
634200;3301011416640;372056;12117413;12489469;11373301;0.053440;quickSort
634300;3301138266640;372156;12119613;12491769;11375301;0.053762;quickSort
634400;331049384448;372256;12121813;12494069;11377301;0.053574;quickSort
634500;331176274448;372356;12124013;12496369;11379301;0.053572;quickSort
634600;331303184448;372456;12126213;12498669;11381301;0.053513;quickSort
634700;331430114448;372556;12128413;12500969;11383301;0.053609;quickSort
634800;331557064448;372656;12130613;12503269;11385301;0.053498;quickSort
634900;331684034448;372756;12132813;12505569;11387301;0.053547;quickSort
635000;331811024448;372856;12135013;12507869;11389301;0.053606;quickSort
635100;331938034448;372956;12137213;12510169;11391301;0.053617;quickSort
635200;3311065064448;373056;12139413;12512469;11393301;0.053769;quickSort
635300;3311192114448;373156;12141613;12514769;11395301;0.054984;quickSort
635400;332103432256;373256;12143813;12517069;11397301;0.053679;quickSort
635500;332230522256;373356;12146013;12519369;11399301;0.053886;quickSort
635600;332357632256;373456;12148213;12521669;11401301;0.053638;quickSort
635700;332484762256;373556;12150413;12523969;11403301;0.053683;quickSort
635800;332611912256;373656;12152613;12526269;11405301;0.053701;quickSort
635900;332739082256;373756;12154813;12528569;11407301;0.053719;quickSort
636000;332866272256;373856;12157013;12530869;11409301;0.053728;quickSort
636100;332993482256;373956;12159213;12533169;11411301;0.053803;quickSort
636200;3321120712256;374056;12161413;12535469;11413301;0.053853;quickSort
636300;333032210064;374156;12163613;12537769;11415301;0.053805;quickSort
636400;333159480064;374256;12165813;12540069;11417301;0.053726;quickSort
636500;333286770064;374356;12168013;12542369;11419301;0.053727;quickSort
636600;333414080064;374456;12170213;12544669;11421301;0.053738;quickSort
636700;333541410064;374556;12172413;12546969;11423301;0.053714;quickSort
636800;333668760064;374656;12174613;12549269;11425301;0.053787;quickSort
636900;333796130064;374756;12176813;12551569;11427301;0.054215;quickSort
637000;333923520064;374856;12179013;12553869;11429301;0.053709;quickSort
637100;3331050930064;374956;12181213;12556169;11431301;0.053812;quickSort
637200;3331178360064;375056;12183413;12558469;11433301;0.053803;quickSort
637300;334090057872;375156;12185613;12560769;11435301;0.053757;quickSort
637400;334217527872;375256;12187813;12563069;11437301;0.054508;quickSort
637500;334345017872;375356;12190013;12565369;11439301;0.054364;quickSort
637600;334472527872;375456;12192213;12567669;11441301;0.054628;quickSort
637700;334600057872;375556;12194413;12569969;11443301;0.054554;quickSort
637800;334727607872;375656;12196613;12572269;11445301;0.054774;quickSort
637900;334855177872;375756;12198813;12574569;11447301;0.053893;quickSort
638000;334982767872;375856;12201013;12576869;11449301;0.053990;quickSort
638100;3341110377872;375956;12203213;12579169;11451301;0.053878;quickSort
638200;335022255680;376056;12205413;12581469;11453301;0.053869;quickSort
638300;335149905680;376156;12207613;12583769;11455301;0.053926;quickSort
638400;335277575680;376256;12209813;12586069;11457301;0.053920;quickSort
638500;335405265680;376356;12212013;12588369;11459301;0.053969;quickSort
638600;335532975680;376456;12214213;12590669;11461301;0.054242;quickSort
638700;335660705680;376556;12216413;12592969;11463301;0.054061;quickSort
638800;335788455680;376656;12218613;12595269;11465301;0.054782;quickSort
638900;335916225680;376756;12220813;12597569;11467301;0.054283;quickSort
639000;3351044015680;376856;12223013;12599869;11469301;0.054175;quickSort
639100;3351171825680;376956;12225213;12602169;11471301;0.054114;quickSort
639200;336083903488;377056;12227413;12604469;11473301;0.054282;quickSort
639300;336211753488;377156;12229613;12606769;11475301;0.054097;quickSort
639400;336339623488;377256;12231813;12609069;11477301;0.054398;quickSort
639500;336467513488;377356;12234013;12611369;11479301;0.055110;quickSort
639600;336595423488;377456;12236213;12613669;11481301;0.054197;quickSort
639700;336723353488;377556;12238413;12615969;11483301;0.053927;quickSort
639800;336851303488;377656;12240613;12618269;11485301;0.053337;quickSort
639900;336979273488;377756;12242813;12620569;11487301;0.054223;quickSort
640000;3361107263488;377856;12245013;12622869;11489301;0.054200;quickSort
640100;337019521296;377956;12247213;12625169;11491301;0.054173;quickSort
640200;337147551296;378056;12249413;12627469;11493301;0.054152;quickSort
640300;337275601296;378156;12251613;12629769;11495301;0.054299;quickSort
640400;337403671296;378256;12253813;12632069;11497301;0.054204;quickSort
640500;337531761296;378356;12256013;12634369;11499301;0.054239;quickSort
640600;337659871296;378456;12258213;12636669;11501301;0.054262;quickSort
640700;337788001296;378556;12260413;12638969;11503301;0.054205;quickSort
640800;337916151296;378656;12262613;12641269;11505301;0.055007;quickSort
640900;3371044321296;378756;12264813;12643569;11507301;0.053197;quickSort
641000;3371172511296;378856;12267013;12645869;11509301;0.054247;quickSort
641100;338084969104;378956;12269213;12648169;11511301;0.054293;quickSort
641200;338213199104;379056;12271413;12650469;11513301;0.054326;quickSort
641300;338341449104;379156;12273613;12652769;11515301;0.054384;quickSort
641400;338469719104;379256;12275813;12655069;11517301;0.054635;quickSort
641500;338598009104;379356;12278013;12657369;11519301;0.054717;quickSort
641600;338726319104;379456;12280213;12659669;11521301;0.054477;quickSort
641700;338854649104;379556;12282413;12661969;11523301;0.053083;quickSort
641800;338982999104;379656;12284613;12664269;11525301;0.054629;quickSort
641900;3381111369104;379756;12286813;12666569;11527301;0.056563;quickSort
642000;339024006912;379856;12289013;12668869;11529301;0.054195;quickSort
642100;339152416912;379956;12291213;12671169;11531301;0.055533;quickSort
642200;339280846912;380056;12293413;12673469;11533301;0.054475;quickSort
642300;339409296912;380156;12295613;12675769;11535301;0.056887;quickSort
642400;339537766912;380256;12297813;12678069;11537301;0.054478;quickSort
642500;339666256912;380356;12300013;12680369;11539301;0.054400;quickSort
642600;339794766912;380456;12302213;12682669;11541301;0.054510;quickSort
642700;339923296912;380556;12304413;12684969;11543301;0.054456;quickSort
642800;3391051846912;380656;12306613;12687269;11545301;0.054360;quickSort
642900;3391180416912;380756;12308813;12689569;11547301;0.054471;quickSort
643000;340093254720;380856;12311013;12691869;11549301;0.054658;quickSort
643100;340221864720;380956;12313213;12694169;11551301;0.054462;quickSort
643200;340350494720;381056;12315413;12696469;11553301;0.054590;quickSort
643300;340479144720;381156;12317613;12698769;11555301;0.054539;quickSort
643400;340607814720;381256;12319813;12701069;11557301;0.054512;quickSort
643500;340736504720;381356;12322013;12703369;11559301;0.054526;quickSort
643600;340865214720;381456;12324213;12705669;11561301;0.054478;quickSort
643700;340993944720;381556;12326413;12707969;11563301;0.054442;quickSort
643800;3401122694720;381656;12328613;12710269;11565301;0.054494;quickSort
643900;341035712528;381756;12330813;12712569;11567301;0.054568;quickSort
644000;341164502528;381856;12333013;12714869;11569301;0.054483;quickSort
644100;341293312528;381956;12335213;12717169;11571301;0.054552;quickSort
644200;341422142528;382056;12337413;12719469;11573301;0.054567;quickSort
644300;341550992528;382156;12339613;12721769;11575301;0.054554;quickSort
644400;341679862528;382256;12341813;12724069;11577301;0.054551;quickSort
644500;341808752528;382356;12344013;12726369;11579301;0.054569;quickSort
644600;341937662528;382456;12346213;12728669;11581301;0.054605;quickSort
644700;3411066592528;382556;12348413;12730969;11583301;0.054674;quickSort
644800;3411195542528;382656;12350613;12733269;11585301;0.054834;quickSort
644900;342108760336;382756;12352813;12735569;11587301;0.054610;quickSort
645000;342237750336;382856;12355013;12737869;11589301;0.054580;quickSort
645100;342366760336;382956;12357213;12740169;11591301;0.054654;quickSort
645200;342495790336;383056;12359413;12742469;11593301;0.054686;quickSort
645300;342624840336;383156;12361613;12744769;11595301;0.054644;quickSort
645400;342753910336;383256;12363813;12747069;11597301;0.055669;quickSort
645500;342883000336;383356;12366013;12749369;11599301;0.055944;quickSort
645600;3421012110336;383456;12368213;12751669;11601301;0.055625;quickSort
645700;3421141240336;383556;12370413;12753969;11603301;0.054719;quickSort
645800;343054638144;383656;12372613;12756269;11605301;0.055351;quickSort
645900;343183808144;383756;12374813;12758569;11607301;0.054833;quickSort
646000;343312998144;383856;12377013;12760869;11609301;0.054716;quickSort
646100;343442208144;383956;12379213;12763169;11611301;0.055318;quickSort
646200;343571438144;384056;12381413;12765469;11613301;0.056064;quickSort
646300;343700688144;384156;12383613;12767769;11615301;0.054790;quickSort
646400;343829958144;384256;12385813;12770069;11617301;0.055493;quickSort
646500;343959248144;384356;12388013;12772369;11619301;0.054392;quickSort
646600;3431088558144;384456;12390213;12774669;11621301;0.054795;quickSort
646700;344002135952;384556;12392413;12776969;11623301;0.054766;quickSort
646800;344131485952;384656;12394613;12779269;11625301;0.054837;quickSort
646900;344260855952;384756;12396813;12781569;11627301;0.054798;quickSort
647000;344390245952;384856;12399013;12783869;11629301;0.054866;quickSort
647100;344519655952;384956;12401213;12786169;11631301;0.054809;quickSort
647200;344649085952;385056;12403413;12788469;11633301;0.054862;quickSort
647300;344778535952;385156;12405613;12790769;11635301;0.054877;quickSort
647400;344908005952;385256;12407813;12793069;11637301;0.054871;quickSort
647500;3441037495952;385356;12410013;12795369;11639301;0.054925;quickSort
647600;3441167005952;385456;12412213;12797669;11641301;0.054865;quickSort
647700;345080783760;385556;12414413;12799969;11643301;0.054887;quickSort
647800;345210333760;385656;12416613;12802269;11645301;0.054960;quickSort
647900;345339903760;385756;12418813;12804569;11647301;0.054930;quickSort
648000;345469493760;385856;12421013;12806869;11649301;0.054867;quickSort
648100;345599103760;385956;12423213;12809169;11651301;0.054961;quickSort
648200;345728733760;386056;12425413;12811469;11653301;0.054935;quickSort
648300;345858383760;386156;12427613;12813769;11655301;0.054952;quickSort
648400;345988053760;386256;12429813;12816069;11657301;0.055391;quickSort
648500;3451117743760;386356;12432013;12818369;11659301;0.054951;quickSort
648600;346031701568;386456;12434213;12820669;11661301;0.054993;quickSort
648700;346161431568;386556;12436413;12822969;11663301;0.054943;quickSort
648800;346291181568;386656;12438613;12825269;11665301;0.054956;quickSort
648900;346420951568;386756;12440813;12827569;11667301;0.055124;quickSort
649000;346550741568;386856;12443013;12829869;11669301;0.056904;quickSort
649100;346680551568;386956;12445213;12832169;11671301;0.057039;quickSort
649200;346810381568;387056;12447413;12834469;11673301;0.055448;quickSort
649300;346940231568;387156;12449613;12836769;11675301;0.055372;quickSort
649400;3461070101568;387256;12451813;12839069;11677301;0.055684;quickSort
649500;3461199991568;387356;12454013;12841369;11679301;0.055143;quickSort
649600;347114149376;387456;12456213;12843669;11681301;0.055136;quickSort
649700;347244079376;387556;12458413;12845969;11683301;0.055155;quickSort
649800;347374029376;387656;12460613;12848269;11685301;0.055063;quickSort
649900;347503999376;387756;12462813;12850569;11687301;0.055106;quickSort
650000;347633989376;387856;12465013;12852869;11689301;0.055051;quickSort
650100;347763999376;387956;12467213;12855169;11691301;0.055331;quickSort
650200;347894029376;388056;12469413;12857469;11693301;0.055155;quickSort
650300;3471024079376;388156;12471613;12859769;11695301;0.055117;quickSort
650400;3471154149376;388256;12473813;12862069;11697301;0.055128;quickSort
650500;348068487184;388356;12476013;12864369;11699301;0.055081;quickSort
650600;348198597184;388456;12478213;12866669;11701301;0.055129;quickSort
650700;348328727184;388556;12480413;12868969;11703301;0.055313;quickSort
650800;348458877184;388656;12482613;12871269;11705301;0.055083;quickSort
650900;348589047184;388756;12484813;12873569;11707301;0.055171;quickSort
651000;348719237184;388856;12487013;12875869;11709301;0.055137;quickSort
651100;348849447184;388956;12489213;12878169;11711301;0.054251;quickSort
651200;348979677184;389056;12491413;12880469;11713301;0.055925;quickSort
651300;3481109927184;389156;12493613;12882769;11715301;0.055770;quickSort
651400;349024444992;389256;12495813;12885069;11717301;0.055272;quickSort
651500;349154734992;389356;12498013;12887369;11719301;0.053848;quickSort
651600;349285044992;389456;12500213;12889669;11721301;0.055287;quickSort
651700;349415374992;389556;12502413;12891969;11723301;0.055492;quickSort
651800;349545724992;389656;12504613;12894269;11725301;0.058050;quickSort
651900;349676094992;389756;12506813;12896569;11727301;0.058091;quickSort
652000;349806484992;389856;12509013;12898869;11729301;0.055335;quickSort
652100;349936894992;389956;12511213;12901169;11731301;0.055315;quickSort
652200;3491067324992;390056;12513413;12903469;11733301;0.055238;quickSort
652300;3491197774992;390156;12515613;12905769;11735301;0.055287;quickSort
652400;350112492800;390256;12517813;12908069;11737301;0.056599;quickSort
652500;350242982800;390356;12520013;12910369;11739301;0.058298;quickSort
652600;350373492800;390456;12522213;12912669;11741301;0.055665;quickSort
652700;350504022800;390556;12524413;12914969;11743301;0.056223;quickSort
652800;350634572800;390656;12526613;12917269;11745301;0.055499;quickSort
652900;350765142800;390756;12528813;12919569;11747301;0.055326;quickSort
653000;350895732800;390856;12531013;12921869;11749301;0.055453;quickSort
653100;3501026342800;390956;12533213;12924169;11751301;0.055497;quickSort
653200;3501156972800;391056;12535413;12926469;11753301;0.055620;quickSort
653300;351071870608;391156;12537613;12928769;11755301;0.055367;quickSort
653400;351202540608;391256;12539813;12931069;11757301;0.055583;quickSort
653500;351333230608;391356;12542013;12933369;11759301;0.054133;quickSort
653600;351463940608;391456;12544213;12935669;11761301;0.055408;quickSort
653700;351594670608;391556;12546413;12937969;11763301;0.055431;quickSort
653800;351725420608;391656;12548613;12940269;11765301;0.055358;quickSort
653900;351856190608;391756;12550813;12942569;11767301;0.055510;quickSort
654000;351986980608;391856;12553013;12944869;11769301;0.055471;quickSort
654100;3511117790608;391956;12555213;12947169;11771301;0.055417;quickSort
654200;352032868416;392056;12557413;12949469;11773301;0.055542;quickSort
654300;352163718416;392156;12559613;12951769;11775301;0.055440;quickSort
654400;352294588416;392256;12561813;12954069;11777301;0.055450;quickSort
654500;352425478416;392356;12564013;12956369;11779301;0.055446;quickSort
654600;352556388416;392456;12566213;12958669;11781301;0.055509;quickSort
654700;352687318416;392556;12568413;12960969;11783301;0.055654;quickSort
654800;352818268416;392656;12570613;12963269;11785301;0.055570;quickSort
654900;352949238416;392756;12572813;12965569;11787301;0.056584;quickSort
655000;3521080228416;392856;12575013;12967869;11789301;0.055549;quickSort
655100;3521211238416;392956;12577213;12970169;11791301;0.055698;quickSort
655200;353126516224;393056;12579413;12972469;11793301;0.055635;quickSort
655300;353257566224;393156;12581613;12974769;11795301;0.055623;quickSort
655400;353388636224;393256;12583813;12977069;11797301;0.055619;quickSort
655500;353519726224;393356;12586013;12979369;11799301;0.060107;quickSort
655600;353650836224;393456;12588213;12981669;11801301;0.055766;quickSort
655700;353781966224;393556;12590413;12983969;11803301;0.055985;quickSort
655800;353913116224;393656;12592613;12986269;11805301;0.055764;quickSort
655900;3531044286224;393756;12594813;12988569;11807301;0.056618;quickSort
656000;3531175476224;393856;12597013;12990869;11809301;0.055632;quickSort
656100;354090934032;393956;12599213;12993169;11811301;0.056770;quickSort
656200;354222164032;394056;12601413;12995469;11813301;0.055625;quickSort
656300;354353414032;394156;12603613;12997769;11815301;0.055772;quickSort
656400;354484684032;394256;12605813;13000069;11817301;0.056237;quickSort
656500;354615974032;394356;12608013;13002369;11819301;0.056363;quickSort
656600;354747284032;394456;12610213;13004669;11821301;0.055844;quickSort
656700;354878614032;394556;12612413;13006969;11823301;0.055787;quickSort
656800;3541009964032;394656;12614613;13009269;11825301;0.055799;quickSort
656900;3541141334032;394756;12616813;13011569;11827301;0.055372;quickSort
657000;355056971840;394856;12619013;13013869;11829301;0.055878;quickSort
657100;355188381840;394956;12621213;13016169;11831301;0.055793;quickSort
657200;355319811840;395056;12623413;13018469;11833301;0.055865;quickSort
657300;355451261840;395156;12625613;13020769;11835301;0.057728;quickSort
657400;355582731840;395256;12627813;13023069;11837301;0.055970;quickSort
657500;355714221840;395356;12630013;13025369;11839301;0.055987;quickSort
657600;355845731840;395456;12632213;13027669;11841301;0.055895;quickSort
657700;355977261840;395556;12634413;13029969;11843301;0.056040;quickSort
657800;3551108811840;395656;12636613;13032269;11845301;0.055829;quickSort
657900;356024629648;395756;12638813;13034569;11847301;0.055935;quickSort
658000;356156219648;395856;12641013;13036869;11849301;0.055918;quickSort
658100;356287829648;395956;12643213;13039169;11851301;0.055936;quickSort
658200;356419459648;396056;12645413;13041469;11853301;0.056114;quickSort
658300;356551109648;396156;12647613;13043769;11855301;0.055945;quickSort
658400;356682779648;396256;12649813;13046069;11857301;0.056084;quickSort
658500;356814469648;396356;12652013;13048369;11859301;0.055885;quickSort
658600;356946179648;396456;12654213;13050669;11861301;0.056188;quickSort
658700;3561077909648;396556;12656413;13052969;11863301;0.054592;quickSort
658800;3561209659648;396656;12658613;13055269;11865301;0.056070;quickSort
658900;357125677456;396756;12660813;13057569;11867301;0.056909;quickSort
659000;357257467456;396856;12663013;13059869;11869301;0.058511;quickSort
659100;357389277456;396956;12665213;13062169;11871301;0.058483;quickSort
659200;357521107456;397056;12667413;13064469;11873301;0.056178;quickSort
659300;357652957456;397156;12669613;13066769;11875301;0.057244;quickSort
659400;357784827456;397256;12671813;13069069;11877301;0.056585;quickSort
659500;357916717456;397356;12674013;13071369;11879301;0.057820;quickSort
659600;3571048627456;397456;12676213;13073669;11881301;0.056489;quickSort
659700;3571180557456;397556;12678413;13075969;11883301;0.056278;quickSort
659800;358096755264;397656;12680613;13078269;11885301;0.057958;quickSort
659900;358228725264;397756;12682813;13080569;11887301;0.056180;quickSort
660000;358360715264;397856;12685013;13082869;11889301;0.056224;quickSort
660100;358492725264;397956;12687213;13085169;11891301;0.056167;quickSort
660200;358624755264;398056;12689413;13087469;11893301;0.056144;quickSort
660300;358756805264;398156;12691613;13089769;11895301;0.056191;quickSort
660400;358888875264;398256;12693813;13092069;11897301;0.056276;quickSort
660500;3581020965264;398356;12696013;13094369;11899301;0.056808;quickSort
660600;3581153075264;398456;12698213;13096669;11901301;0.058027;quickSort
660700;359069453072;398556;12700413;13098969;11903301;0.056451;quickSort
660800;359201603072;398656;12702613;13101269;11905301;0.056383;quickSort
660900;359333773072;398756;12704813;13103569;11907301;0.056393;quickSort
661000;359465963072;398856;12707013;13105869;11909301;0.056481;quickSort
661100;359598173072;398956;12709213;13108169;11911301;0.056566;quickSort
661200;359730403072;399056;12711413;13110469;11913301;0.056215;quickSort
661300;359862653072;399156;12713613;13112769;11915301;0.056695;quickSort
661400;359994923072;399256;12715813;13115069;11917301;0.056501;quickSort
661500;3591127213072;399356;12718013;13117369;11919301;0.056645;quickSort
661600;360043770880;399456;12720213;13119669;11921301;0.056548;quickSort
661700;360176100880;399556;12722413;13121969;11923301;0.057208;quickSort
661800;360308450880;399656;12724613;13124269;11925301;0.059402;quickSort
661900;360440820880;399756;12726813;13126569;11927301;0.057159;quickSort
662000;360573210880;399856;12729013;13128869;11929301;0.056452;quickSort
662100;360705620880;399956;12731213;13131169;11931301;0.056826;quickSort
662200;360838050880;400056;12733413;13133469;11933301;0.057228;quickSort
662300;360970500880;400156;12735613;13135769;11935301;0.057650;quickSort
662400;3601102970880;400256;12737813;13138069;11937301;0.060895;quickSort
662500;361019708688;400356;12740013;13140369;11939301;0.058071;quickSort
662600;361152218688;400456;12742213;13142669;11941301;0.056579;quickSort
662700;361284748688;400556;12744413;13144969;11943301;0.056056;quickSort
662800;361417298688;400656;12746613;13147269;11945301;0.057433;quickSort
662900;361549868688;400756;12748813;13149569;11947301;0.056680;quickSort
663000;361682458688;400856;12751013;13151869;11949301;0.056574;quickSort
663100;361815068688;400956;12753213;13154169;11951301;0.056579;quickSort
663200;361947698688;401056;12755413;13156469;11953301;0.056634;quickSort
663300;3611080348688;401156;12757613;13158769;11955301;0.057671;quickSort
663400;3611213018688;401256;12759813;13161069;11957301;0.056618;quickSort
663500;362129956496;401356;12762013;13163369;11959301;0.056826;quickSort
663600;362262666496;401456;12764213;13165669;11961301;0.056663;quickSort
663700;362395396496;401556;12766413;13167969;11963301;0.056730;quickSort
663800;362528146496;401656;12768613;13170269;11965301;0.056628;quickSort
663900;362660916496;401756;12770813;13172569;11967301;0.056794;quickSort
664000;362793706496;401856;12773013;13174869;11969301;0.056558;quickSort
664100;362926516496;401956;12775213;13177169;11971301;0.056569;quickSort
664200;3621059346496;402056;12777413;13179469;11973301;0.055339;quickSort
664300;3621192196496;402156;12779613;13181769;11975301;0.056712;quickSort
664400;363109314304;402256;12781813;13184069;11977301;0.056698;quickSort
664500;363242204304;402356;12784013;13186369;11979301;0.056727;quickSort
664600;363375114304;402456;12786213;13188669;11981301;0.058055;quickSort
664700;363508044304;402556;12788413;13190969;11983301;0.059070;quickSort
664800;363640994304;402656;12790613;13193269;11985301;0.057101;quickSort
664900;363773964304;402756;12792813;13195569;11987301;0.058019;quickSort
665000;363906954304;402856;12795013;13197869;11989301;0.057701;quickSort
665100;3631039964304;402956;12797213;13200169;11991301;0.056820;quickSort
665200;3631172994304;403056;12799413;13202469;11993301;0.056733;quickSort
665300;364090292112;403156;12801613;13204769;11995301;0.056736;quickSort
665400;364223362112;403256;12803813;13207069;11997301;0.056978;quickSort
665500;364356452112;403356;12806013;13209369;11999301;0.055844;quickSort
665600;364489562112;403456;12808213;13211669;12001301;0.057042;quickSort
665700;364622692112;403556;12810413;13213969;12003301;0.057481;quickSort
665800;364755842112;403656;12812613;13216269;12005301;0.057053;quickSort
665900;364889012112;403756;12814813;13218569;12007301;0.057176;quickSort
666000;3641022202112;403856;12817013;13220869;12009301;0.059274;quickSort
666100;3641155412112;403956;12819213;13223169;12011301;0.059276;quickSort
666200;365072889920;404056;12821413;13225469;12013301;0.057497;quickSort
666300;365206139920;404156;12823613;13227769;12015301;0.057255;quickSort
666400;365339409920;404256;12825813;13230069;12017301;0.058159;quickSort
666500;365472699920;404356;12828013;13232369;12019301;0.056964;quickSort
666600;365606009920;404456;12830213;13234669;12021301;0.056948;quickSort
666700;365739339920;404556;12832413;13236969;12023301;0.056985;quickSort
666800;365872689920;404656;12834613;13239269;12025301;0.057065;quickSort
666900;3651006059920;404756;12836813;13241569;12027301;0.057065;quickSort
667000;3651139449920;404856;12839013;13243869;12029301;0.057048;quickSort
667100;366057107728;404956;12841213;13246169;12031301;0.057075;quickSort
667200;366190537728;405056;12843413;13248469;12033301;0.057190;quickSort
667300;366323987728;405156;12845613;13250769;12035301;0.057045;quickSort
667400;366457457728;405256;12847813;13253069;12037301;0.057151;quickSort
667500;366590947728;405356;12850013;13255369;12039301;0.057833;quickSort
667600;366724457728;405456;12852213;13257669;12041301;0.057105;quickSort
667700;366857987728;405556;12854413;13259969;12043301;0.057105;quickSort
667800;366991537728;405656;12856613;13262269;12045301;0.057301;quickSort
667900;3661125107728;405756;12858813;13264569;12047301;0.057289;quickSort
668000;367042945536;405856;12861013;13266869;12049301;0.057129;quickSort
668100;367176555536;405956;12863213;13269169;12051301;0.057087;quickSort
668200;367310185536;406056;12865413;13271469;12053301;0.057174;quickSort
668300;367443835536;406156;12867613;13273769;12055301;0.057174;quickSort
668400;367577505536;406256;12869813;13276069;12057301;0.057165;quickSort
668500;367711195536;406356;12872013;13278369;12059301;0.057239;quickSort
668600;367844905536;406456;12874213;13280669;12061301;0.056024;quickSort
668700;367978635536;406556;12876413;13282969;12063301;0.057284;quickSort
668800;3671112385536;406656;12878613;13285269;12065301;0.057281;quickSort
668900;368030403344;406756;12880813;13287569;12067301;0.057305;quickSort
669000;368164193344;406856;12883013;13289869;12069301;0.057218;quickSort
669100;368298003344;406956;12885213;13292169;12071301;0.057225;quickSort
669200;368431833344;407056;12887413;13294469;12073301;0.057214;quickSort
669300;368565683344;407156;12889613;13296769;12075301;0.057832;quickSort
669400;368699553344;407256;12891813;13299069;12077301;0.058613;quickSort
669500;368833443344;407356;12894013;13301369;12079301;0.057569;quickSort
669600;368967353344;407456;12896213;13303669;12081301;0.057841;quickSort
669700;3681101283344;407556;12898413;13305969;12083301;0.058957;quickSort
669800;369019481152;407656;12900613;13308269;12085301;0.058037;quickSort
669900;369153451152;407756;12902813;13310569;12087301;0.057877;quickSort
670000;369287441152;407856;12905013;13312869;12089301;0.058093;quickSort
670100;369421451152;407956;12907213;13315169;12091301;0.057849;quickSort
670200;369555481152;408056;12909413;13317469;12093301;0.057549;quickSort
670300;369689531152;408156;12911613;13319769;12095301;0.057701;quickSort
670400;369823601152;408256;12913813;13322069;12097301;0.057482;quickSort
670500;369957691152;408356;12916013;13324369;12099301;0.056534;quickSort
670600;3691091801152;408456;12918213;13326669;12101301;0.059816;quickSort
670700;370010178960;408556;12920413;13328969;12103301;0.063342;quickSort
670800;370144328960;408656;12922613;13331269;12105301;0.077206;quickSort
670900;370278498960;408756;12924813;13333569;12107301;0.072783;quickSort
671000;370412688960;408856;12927013;13335869;12109301;0.059221;quickSort
671100;370546898960;408956;12929213;13338169;12111301;0.056747;quickSort
671200;370681128960;409056;12931413;13340469;12113301;0.060147;quickSort
671300;370815378960;409156;12933613;13342769;12115301;0.060686;quickSort
671400;370949648960;409256;12935813;13345069;12117301;0.063899;quickSort
671500;3701083938960;409356;12938013;13347369;12119301;0.066355;quickSort
671600;371002496768;409456;12940213;13349669;12121301;0.057783;quickSort
671700;371136826768;409556;12942413;13351969;12123301;0.057929;quickSort
671800;371271176768;409656;12944613;13354269;12125301;0.058377;quickSort
671900;371405546768;409756;12946813;13356569;12127301;0.059557;quickSort
672000;371539936768;409856;12949013;13358869;12129301;0.057881;quickSort
672100;371674346768;409956;12951213;13361169;12131301;0.060046;quickSort
672200;371808776768;410056;12953413;13363469;12133301;0.062668;quickSort
672300;371943226768;410156;12955613;13365769;12135301;0.061049;quickSort
672400;3711077696768;410256;12957813;13368069;12137301;0.062729;quickSort
672500;3711212186768;410356;12960013;13370369;12139301;0.059511;quickSort
672600;372130944576;410456;12962213;13372669;12141301;0.060626;quickSort
672700;372265474576;410556;12964413;13374969;12143301;0.057812;quickSort
672800;372400024576;410656;12966613;13377269;12145301;0.059623;quickSort
672900;372534594576;410756;12968813;13379569;12147301;0.059632;quickSort
673000;372669184576;410856;12971013;13381869;12149301;0.058304;quickSort
673100;372803794576;410956;12973213;13384169;12151301;0.059585;quickSort
673200;372938424576;411056;12975413;13386469;12153301;0.058693;quickSort
673300;3721073074576;411156;12977613;13388769;12155301;0.057966;quickSort
673400;3721207744576;411256;12979813;13391069;12157301;0.058218;quickSort
673500;373126682384;411356;12982013;13393369;12159301;0.058291;quickSort
673600;373261392384;411456;12984213;13395669;12161301;0.058253;quickSort
673700;373396122384;411556;12986413;13397969;12163301;0.058324;quickSort
673800;373530872384;411656;12988613;13400269;12165301;0.058718;quickSort
673900;373665642384;411756;12990813;13402569;12167301;0.057916;quickSort
674000;373800432384;411856;12993013;13404869;12169301;0.058474;quickSort
674100;373935242384;411956;12995213;13407169;12171301;0.057900;quickSort
674200;3731070072384;412056;12997413;13409469;12173301;0.058031;quickSort
674300;3731204922384;412156;12999613;13411769;12175301;0.057973;quickSort
674400;374124040192;412256;13001813;13414069;12177301;0.057870;quickSort
674500;374258930192;412356;13004013;13416369;12179301;0.057956;quickSort
674600;374393840192;412456;13006213;13418669;12181301;0.057869;quickSort
674700;374528770192;412556;13008413;13420969;12183301;0.057923;quickSort
674800;374663720192;412656;13010613;13423269;12185301;0.058010;quickSort
674900;374798690192;412756;13012813;13425569;12187301;0.058221;quickSort
675000;374933680192;412856;13015013;13427869;12189301;0.058163;quickSort
675100;3741068690192;412956;13017213;13430169;12191301;0.058061;quickSort
675200;3741203720192;413056;13019413;13432469;12193301;0.058174;quickSort
675300;375123018000;413156;13021613;13434769;12195301;0.058162;quickSort
675400;375258088000;413256;13023813;13437069;12197301;0.058111;quickSort
675500;375393178000;413356;13026013;13439369;12199301;0.058183;quickSort
675600;375528288000;413456;13028213;13441669;12201301;0.058167;quickSort
675700;375663418000;413556;13030413;13443969;12203301;0.058112;quickSort
675800;375798568000;413656;13032613;13446269;12205301;0.058147;quickSort
675900;375933738000;413756;13034813;13448569;12207301;0.058039;quickSort
676000;3751068928000;413856;13037013;13450869;12209301;0.058392;quickSort
676100;3751204138000;413956;13039213;13453169;12211301;0.058105;quickSort
676200;376123615808;414056;13041413;13455469;12213301;0.058149;quickSort
676300;376258865808;414156;13043613;13457769;12215301;0.058150;quickSort
676400;376394135808;414256;13045813;13460069;12217301;0.058450;quickSort
676500;376529425808;414356;13048013;13462369;12219301;0.058201;quickSort
676600;376664735808;414456;13050213;13464669;12221301;0.058133;quickSort
676700;376800065808;414556;13052413;13466969;12223301;0.058216;quickSort
676800;376935415808;414656;13054613;13469269;12225301;0.058261;quickSort
676900;3761070785808;414756;13056813;13471569;12227301;0.058309;quickSort
677000;3761206175808;414856;13059013;13473869;12229301;0.058361;quickSort
677100;377125833616;414956;13061213;13476169;12231301;0.058268;quickSort
677200;377261263616;415056;13063413;13478469;12233301;0.059349;quickSort
677300;377396713616;415156;13065613;13480769;12235301;0.058484;quickSort
677400;377532183616;415256;13067813;13483069;12237301;0.058801;quickSort
677500;377667673616;415356;13070013;13485369;12239301;0.059478;quickSort
677600;377803183616;415456;13072213;13487669;12241301;0.058741;quickSort
677700;377938713616;415556;13074413;13489969;12243301;0.058569;quickSort
677800;3771074263616;415656;13076613;13492269;12245301;0.058350;quickSort
677900;3771209833616;415756;13078813;13494569;12247301;0.058918;quickSort
678000;378129671424;415856;13081013;13496869;12249301;0.060109;quickSort
678100;378265281424;415956;13083213;13499169;12251301;0.060305;quickSort
678200;378400911424;416056;13085413;13501469;12253301;0.058291;quickSort
678300;378536561424;416156;13087613;13503769;12255301;0.058481;quickSort
678400;378672231424;416256;13089813;13506069;12257301;0.058425;quickSort
678500;378807921424;416356;13092013;13508369;12259301;0.059348;quickSort
678600;378943631424;416456;13094213;13510669;12261301;0.060298;quickSort
678700;3781079361424;416556;13096413;13512969;12263301;0.058477;quickSort
678800;3781215111424;416656;13098613;13515269;12265301;0.058458;quickSort
678900;379135129232;416756;13100813;13517569;12267301;0.059659;quickSort
679000;379270919232;416856;13103013;13519869;12269301;0.058437;quickSort
679100;379406729232;416956;13105213;13522169;12271301;0.058455;quickSort
679200;379542559232;417056;13107413;13524469;12273301;0.057157;quickSort
679300;379678409232;417156;13109613;13526769;12275301;0.058442;quickSort
679400;379814279232;417256;13111813;13529069;12277301;0.058599;quickSort
679500;379950169232;417356;13114013;13531369;12279301;0.058436;quickSort
679600;3791086079232;417456;13116213;13533669;12281301;0.058612;quickSort
679700;380006257040;417556;13118413;13535969;12283301;0.058512;quickSort
679800;380142207040;417656;13120613;13538269;12285301;0.058611;quickSort
679900;380278177040;417756;13122813;13540569;12287301;0.057055;quickSort
680000;380414167040;417856;13125013;13542869;12289301;0.058548;quickSort
680100;380550177040;417956;13127213;13545169;12291301;0.058585;quickSort
680200;380686207040;418056;13129413;13547469;12293301;0.058605;quickSort
680300;380822257040;418156;13131613;13549769;12295301;0.058660;quickSort
680400;380958327040;418256;13133813;13552069;12297301;0.058629;quickSort
680500;3801094417040;418356;13136013;13554369;12299301;0.058664;quickSort
680600;381014774848;418456;13138213;13556669;12301301;0.058759;quickSort
680700;381150904848;418556;13140413;13558969;12303301;0.058549;quickSort
680800;381287054848;418656;13142613;13561269;12305301;0.058661;quickSort
680900;381423224848;418756;13144813;13563569;12307301;0.058582;quickSort
681000;381559414848;418856;13147013;13565869;12309301;0.058619;quickSort
681100;381695624848;418956;13149213;13568169;12311301;0.058757;quickSort
681200;381831854848;419056;13151413;13570469;12313301;0.058677;quickSort
681300;381968104848;419156;13153613;13572769;12315301;0.058670;quickSort
681400;3811104374848;419256;13155813;13575069;12317301;0.057344;quickSort
681500;382024912656;419356;13158013;13577369;12319301;0.058695;quickSort
681600;382161222656;419456;13160213;13579669;12321301;0.058730;quickSort
681700;382297552656;419556;13162413;13581969;12323301;0.058794;quickSort
681800;382433902656;419656;13164613;13584269;12325301;0.058817;quickSort
681900;382570272656;419756;13166813;13586569;12327301;0.058826;quickSort
682000;382706662656;419856;13169013;13588869;12329301;0.058733;quickSort
682100;382843072656;419956;13171213;13591169;12331301;0.059222;quickSort
682200;382979502656;420056;13173413;13593469;12333301;0.060509;quickSort
682300;3821115952656;420156;13175613;13595769;12335301;0.058776;quickSort
682400;383036670464;420256;13177813;13598069;12337301;0.058761;quickSort
682500;383173160464;420356;13180013;13600369;12339301;0.058770;quickSort
682600;383309670464;420456;13182213;13602669;12341301;0.058812;quickSort
682700;383446200464;420556;13184413;13604969;12343301;0.058775;quickSort
682800;383582750464;420656;13186613;13607269;12345301;0.058904;quickSort
682900;383719320464;420756;13188813;13609569;12347301;0.058845;quickSort
683000;383855910464;420856;13191013;13611869;12349301;0.058997;quickSort
683100;383992520464;420956;13193213;13614169;12351301;0.058917;quickSort
683200;3831129150464;421056;13195413;13616469;12353301;0.059014;quickSort
683300;384050048272;421156;13197613;13618769;12355301;0.059042;quickSort
683400;384186718272;421256;13199813;13621069;12357301;0.059047;quickSort
683500;384323408272;421356;13202013;13623369;12359301;0.059331;quickSort
683600;384460118272;421456;13204213;13625669;12361301;0.059624;quickSort
683700;384596848272;421556;13206413;13627969;12363301;0.059004;quickSort
683800;384733598272;421656;13208613;13630269;12365301;0.060282;quickSort
683900;384870368272;421756;13210813;13632569;12367301;0.059290;quickSort
684000;3841007158272;421856;13213013;13634869;12369301;0.059655;quickSort
684100;3841143968272;421956;13215213;13637169;12371301;0.059382;quickSort
684200;385065046080;422056;13217413;13639469;12373301;0.059160;quickSort
684300;385201896080;422156;13219613;13641769;12375301;0.059240;quickSort
684400;385338766080;422256;13221813;13644069;12377301;0.060023;quickSort
684500;385475656080;422356;13224013;13646369;12379301;0.059594;quickSort
684600;385612566080;422456;13226213;13648669;12381301;0.059466;quickSort
684700;385749496080;422556;13228413;13650969;12383301;0.059264;quickSort
684800;385886446080;422656;13230613;13653269;12385301;0.059222;quickSort
684900;3851023416080;422756;13232813;13655569;12387301;0.059135;quickSort
685000;3851160406080;422856;13235013;13657869;12389301;0.059681;quickSort
685100;386081663888;422956;13237213;13660169;12391301;0.059899;quickSort
685200;386218693888;423056;13239413;13662469;12393301;0.059811;quickSort
685300;386355743888;423156;13241613;13664769;12395301;0.059608;quickSort
685400;386492813888;423256;13243813;13667069;12397301;0.060674;quickSort
685500;386629903888;423356;13246013;13669369;12399301;0.059288;quickSort
685600;386767013888;423456;13248213;13671669;12401301;0.059192;quickSort
685700;386904143888;423556;13250413;13673969;12403301;0.059292;quickSort
685800;3861041293888;423656;13252613;13676269;12405301;0.059222;quickSort
685900;3861178463888;423756;13254813;13678569;12407301;0.059311;quickSort
686000;387099901696;423856;13257013;13680869;12409301;0.059274;quickSort
686100;387237111696;423956;13259213;13683169;12411301;0.059604;quickSort
686200;387374341696;424056;13261413;13685469;12413301;0.059484;quickSort
686300;387511591696;424156;13263613;13687769;12415301;0.059964;quickSort
686400;387648861696;424256;13265813;13690069;12417301;0.059412;quickSort
686500;387786151696;424356;13268013;13692369;12419301;0.059960;quickSort
686600;387923461696;424456;13270213;13694669;12421301;0.059405;quickSort
686700;3871060791696;424556;13272413;13696969;12423301;0.059441;quickSort
686800;3871198141696;424656;13274613;13699269;12425301;0.059350;quickSort
686900;388119759504;424756;13276813;13701569;12427301;0.061133;quickSort
687000;388257149504;424856;13279013;13703869;12429301;0.060995;quickSort
687100;388394559504;424956;13281213;13706169;12431301;0.061958;quickSort
687200;388531989504;425056;13283413;13708469;12433301;0.060905;quickSort
687300;388669439504;425156;13285613;13710769;12435301;0.059590;quickSort
687400;388806909504;425256;13287813;13713069;12437301;0.059750;quickSort
687500;388944399504;425356;13290013;13715369;12439301;0.059351;quickSort
687600;3881081909504;425456;13292213;13717669;12441301;0.059565;quickSort
687700;389003687312;425556;13294413;13719969;12443301;0.059500;quickSort
687800;389141237312;425656;13296613;13722269;12445301;0.060765;quickSort
687900;389278807312;425756;13298813;13724569;12447301;0.059506;quickSort
688000;389416397312;425856;13301013;13726869;12449301;0.059483;quickSort
688100;389554007312;425956;13303213;13729169;12451301;0.059675;quickSort
688200;389691637312;426056;13305413;13731469;12453301;0.060034;quickSort
688300;389829287312;426156;13307613;13733769;12455301;0.059543;quickSort
688400;389966957312;426256;13309813;13736069;12457301;0.059655;quickSort
688500;3891104647312;426356;13312013;13738369;12459301;0.059519;quickSort
688600;390026605120;426456;13314213;13740669;12461301;0.059606;quickSort
688700;390164335120;426556;13316413;13742969;12463301;0.059539;quickSort
688800;390302085120;426656;13318613;13745269;12465301;0.059502;quickSort
688900;390439855120;426756;13320813;13747569;12467301;0.059484;quickSort
689000;390577645120;426856;13323013;13749869;12469301;0.059512;quickSort
689100;390715455120;426956;13325213;13752169;12471301;0.059533;quickSort
689200;390853285120;427056;13327413;13754469;12473301;0.059710;quickSort
689300;390991135120;427156;13329613;13756769;12475301;0.059601;quickSort
689400;3901129005120;427256;13331813;13759069;12477301;0.059610;quickSort
689500;391051142928;427356;13334013;13761369;12479301;0.059448;quickSort
689600;391189052928;427456;13336213;13763669;12481301;0.059658;quickSort
689700;391326982928;427556;13338413;13765969;12483301;0.059590;quickSort
689800;391464932928;427656;13340613;13768269;12485301;0.059529;quickSort
689900;391602902928;427756;13342813;13770569;12487301;0.058180;quickSort
690000;391740892928;427856;13345013;13772869;12489301;0.059625;quickSort
690100;391878902928;427956;13347213;13775169;12491301;0.059558;quickSort
690200;3911016932928;428056;13349413;13777469;12493301;0.059735;quickSort
690300;3911154982928;428156;13351613;13779769;12495301;0.059731;quickSort
690400;392077300736;428256;13353813;13782069;12497301;0.059676;quickSort
690500;392215390736;428356;13356013;13784369;12499301;0.059707;quickSort
690600;392353500736;428456;13358213;13786669;12501301;0.059636;quickSort
690700;392491630736;428556;13360413;13788969;12503301;0.059677;quickSort
690800;392629780736;428656;13362613;13791269;12505301;0.059775;quickSort
690900;392767950736;428756;13364813;13793569;12507301;0.060095;quickSort
691000;392906140736;428856;13367013;13795869;12509301;0.061040;quickSort
691100;3921044350736;428956;13369213;13798169;12511301;0.059722;quickSort
691200;3921182580736;429056;13371413;13800469;12513301;0.059764;quickSort
691300;393105078544;429156;13373613;13802769;12515301;0.059769;quickSort
691400;393243348544;429256;13375813;13805069;12517301;0.060150;quickSort
691500;393381638544;429356;13378013;13807369;12519301;0.059856;quickSort
691600;393519948544;429456;13380213;13809669;12521301;0.060838;quickSort
691700;393658278544;429556;13382413;13811969;12523301;0.059857;quickSort
691800;393796628544;429656;13384613;13814269;12525301;0.058449;quickSort
691900;393934998544;429756;13386813;13816569;12527301;0.059771;quickSort
692000;3931073388544;429856;13389013;13818869;12529301;0.059760;quickSort
692100;3931211798544;429956;13391213;13821169;12531301;0.059895;quickSort
692200;394134476352;430056;13393413;13823469;12533301;0.059870;quickSort
692300;394272926352;430156;13395613;13825769;12535301;0.059840;quickSort
692400;394411396352;430256;13397813;13828069;12537301;0.059867;quickSort
692500;394549886352;430356;13400013;13830369;12539301;0.059828;quickSort
692600;394688396352;430456;13402213;13832669;12541301;0.059903;quickSort
692700;394826926352;430556;13404413;13834969;12543301;0.059844;quickSort
692800;394965476352;430656;13406613;13837269;12545301;0.059955;quickSort
692900;3941104046352;430756;13408813;13839569;12547301;0.060003;quickSort
693000;395026884160;430856;13411013;13841869;12549301;0.059842;quickSort
693100;395165494160;430956;13413213;13844169;12551301;0.060013;quickSort
693200;395304124160;431056;13415413;13846469;12553301;0.060003;quickSort
693300;395442774160;431156;13417613;13848769;12555301;0.059906;quickSort
693400;395581444160;431256;13419813;13851069;12557301;0.060036;quickSort
693500;395720134160;431356;13422013;13853369;12559301;0.059992;quickSort
693600;395858844160;431456;13424213;13855669;12561301;0.059971;quickSort
693700;395997574160;431556;13426413;13857969;12563301;0.060114;quickSort
693800;3951136324160;431656;13428613;13860269;12565301;0.060056;quickSort
693900;396059341968;431756;13430813;13862569;12567301;0.060112;quickSort
694000;396198131968;431856;13433013;13864869;12569301;0.060196;quickSort
694100;396336941968;431956;13435213;13867169;12571301;0.060690;quickSort
694200;396475771968;432056;13437413;13869469;12573301;0.060334;quickSort
694300;396614621968;432156;13439613;13871769;12575301;0.060528;quickSort
694400;396753491968;432256;13441813;13874069;12577301;0.061038;quickSort
694500;396892381968;432356;13444013;13876369;12579301;0.060698;quickSort
694600;3961031291968;432456;13446213;13878669;12581301;0.060484;quickSort
694700;3961170221968;432556;13448413;13880969;12583301;0.060364;quickSort
694800;397093419776;432656;13450613;13883269;12585301;0.060118;quickSort
694900;397232389776;432756;13452813;13885569;12587301;0.060101;quickSort
695000;397371379776;432856;13455013;13887869;12589301;0.060200;quickSort
695100;397510389776;432956;13457213;13890169;12591301;0.060197;quickSort
695200;397649419776;433056;13459413;13892469;12593301;0.060080;quickSort
695300;397788469776;433156;13461613;13894769;12595301;0.059611;quickSort
695400;397927539776;433256;13463813;13897069;12597301;0.061931;quickSort
695500;3971066629776;433356;13466013;13899369;12599301;0.060185;quickSort
695600;3971205739776;433456;13468213;13901669;12601301;0.060399;quickSort
695700;398129117584;433556;13470413;13903969;12603301;0.062349;quickSort
695800;398268267584;433656;13472613;13906269;12605301;0.060174;quickSort
695900;398407437584;433756;13474813;13908569;12607301;0.060217;quickSort
696000;398546627584;433856;13477013;13910869;12609301;0.060157;quickSort
696100;398685837584;433956;13479213;13913169;12611301;0.060225;quickSort
696200;398825067584;434056;13481413;13915469;12613301;0.060299;quickSort
696300;398964317584;434156;13483613;13917769;12615301;0.060403;quickSort
696400;3981103587584;434256;13485813;13920069;12617301;0.059037;quickSort
696500;399027125392;434356;13488013;13922369;12619301;0.060191;quickSort
696600;399166435392;434456;13490213;13924669;12621301;0.061350;quickSort
696700;399305765392;434556;13492413;13926969;12623301;0.060480;quickSort
696800;399445115392;434656;13494613;13929269;12625301;0.060343;quickSort
696900;399584485392;434756;13496813;13931569;12627301;0.059448;quickSort
697000;399723875392;434856;13499013;13933869;12629301;0.060385;quickSort
697100;399863285392;434956;13501213;13936169;12631301;0.060454;quickSort
697200;3991002715392;435056;13503413;13938469;12633301;0.062191;quickSort
697300;3991142165392;435156;13505613;13940769;12635301;0.060521;quickSort
697400;400065883200;435256;13507813;13943069;12637301;0.060238;quickSort
697500;400205373200;435356;13510013;13945369;12639301;0.060723;quickSort
697600;400344883200;435456;13512213;13947669;12641301;0.061031;quickSort
697700;400484413200;435556;13514413;13949969;12643301;0.061167;quickSort
697800;400623963200;435656;13516613;13952269;12645301;0.062269;quickSort
697900;400763533200;435756;13518813;13954569;12647301;0.060416;quickSort
698000;400903123200;435856;13521013;13956869;12649301;0.060723;quickSort
698100;4001042733200;435956;13523213;13959169;12651301;0.060986;quickSort
698200;4001182363200;436056;13525413;13961469;12653301;0.061294;quickSort
698300;401106261008;436156;13527613;13963769;12655301;0.060495;quickSort
698400;401245931008;436256;13529813;13966069;12657301;0.060481;quickSort
698500;401385621008;436356;13532013;13968369;12659301;0.060743;quickSort
698600;401525331008;436456;13534213;13970669;12661301;0.060433;quickSort
698700;401665061008;436556;13536413;13972969;12663301;0.060533;quickSort
698800;401804811008;436656;13538613;13975269;12665301;0.061332;quickSort
698900;401944581008;436756;13540813;13977569;12667301;0.060550;quickSort
699000;4011084371008;436856;13543013;13979869;12669301;0.060652;quickSort
699100;402008428816;436956;13545213;13982169;12671301;0.060967;quickSort
699200;402148258816;437056;13547413;13984469;12673301;0.061581;quickSort
699300;402288108816;437156;13549613;13986769;12675301;0.060612;quickSort
699400;402427978816;437256;13551813;13989069;12677301;0.061090;quickSort
699500;402567868816;437356;13554013;13991369;12679301;0.061032;quickSort
699600;402707778816;437456;13556213;13993669;12681301;0.060426;quickSort
699700;402847708816;437556;13558413;13995969;12683301;0.062438;quickSort
699800;402987658816;437656;13560613;13998269;12685301;0.061298;quickSort
699900;4021127628816;437756;13562813;14000569;12687301;0.061739;quickSort
700000;403051866624;437856;13565013;14002869;12689301;0.061231;quickSort
700100;403191876624;437956;13567213;14005169;12691301;0.061590;quickSort
700200;403331906624;438056;13569413;14007469;12693301;0.062080;quickSort
700300;403471956624;438156;13571613;14009769;12695301;0.061822;quickSort
700400;403612026624;438256;13573813;14012069;12697301;0.063351;quickSort
700500;403752116624;438356;13576013;14014369;12699301;0.062787;quickSort
700600;403892226624;438456;13578213;14016669;12701301;0.061243;quickSort
700700;4031032356624;438556;13580413;14018969;12703301;0.062333;quickSort
700800;4031172506624;438656;13582613;14021269;12705301;0.061163;quickSort
700900;404096924432;438756;13584813;14023569;12707301;0.060906;quickSort
701000;404237114432;438856;13587013;14025869;12709301;0.060790;quickSort
701100;404377324432;438956;13589213;14028169;12711301;0.060735;quickSort
701200;404517554432;439056;13591413;14030469;12713301;0.062211;quickSort
701300;404657804432;439156;13593613;14032769;12715301;0.060736;quickSort
701400;404798074432;439256;13595813;14035069;12717301;0.060860;quickSort
701500;404938364432;439356;13598013;14037369;12719301;0.060863;quickSort
701600;4041078674432;439456;13600213;14039669;12721301;0.060800;quickSort
701700;405003252240;439556;13602413;14041969;12723301;0.060852;quickSort
701800;405143602240;439656;13604613;14044269;12725301;0.060952;quickSort
701900;405283972240;439756;13606813;14046569;12727301;0.060933;quickSort
702000;405424362240;439856;13609013;14048869;12729301;0.060865;quickSort
702100;405564772240;439956;13611213;14051169;12731301;0.060909;quickSort
702200;405705202240;440056;13613413;14053469;12733301;0.060948;quickSort
702300;405845652240;440156;13615613;14055769;12735301;0.060848;quickSort
702400;405986122240;440256;13617813;14058069;12737301;0.060947;quickSort
702500;4051126612240;440356;13620013;14060369;12739301;0.060907;quickSort
702600;406051370048;440456;13622213;14062669;12741301;0.060968;quickSort
702700;406191900048;440556;13624413;14064969;12743301;0.060905;quickSort
702800;406332450048;440656;13626613;14067269;12745301;0.060937;quickSort
702900;406473020048;440756;13628813;14069569;12747301;0.061022;quickSort
703000;406613610048;440856;13631013;14071869;12749301;0.062321;quickSort
703100;406754220048;440956;13633213;14074169;12751301;0.060986;quickSort
703200;406894850048;441056;13635413;14076469;12753301;0.060991;quickSort
703300;4061035500048;441156;13637613;14078769;12755301;0.061044;quickSort
703400;4061176170048;441256;13639813;14081069;12757301;0.060163;quickSort
703500;407101107856;441356;13642013;14083369;12759301;0.060293;quickSort
703600;407241817856;441456;13644213;14085669;12761301;0.061063;quickSort
703700;407382547856;441556;13646413;14087969;12763301;0.060985;quickSort
703800;407523297856;441656;13648613;14090269;12765301;0.061216;quickSort
703900;407664067856;441756;13650813;14092569;12767301;0.060980;quickSort
704000;407804857856;441856;13653013;14094869;12769301;0.060984;quickSort
704100;407945667856;441956;13655213;14097169;12771301;0.061109;quickSort
704200;4071086497856;442056;13657413;14099469;12773301;0.061102;quickSort
704300;408011595664;442156;13659613;14101769;12775301;0.061446;quickSort
704400;408152465664;442256;13661813;14104069;12777301;0.061161;quickSort
704500;408293355664;442356;13664013;14106369;12779301;0.061098;quickSort
704600;408434265664;442456;13666213;14108669;12781301;0.061148;quickSort
704700;408575195664;442556;13668413;14110969;12783301;0.061228;quickSort
704800;408716145664;442656;13670613;14113269;12785301;0.062563;quickSort
704900;408857115664;442756;13672813;14115569;12787301;0.061149;quickSort
705000;408998105664;442856;13675013;14117869;12789301;0.059830;quickSort
705100;4081139115664;442956;13677213;14120169;12791301;0.061296;quickSort
705200;409064393472;443056;13679413;14122469;12793301;0.061211;quickSort
705300;409205443472;443156;13681613;14124769;12795301;0.061205;quickSort
705400;409346513472;443256;13683813;14127069;12797301;0.061117;quickSort
705500;409487603472;443356;13686013;14129369;12799301;0.062236;quickSort
705600;409628713472;443456;13688213;14131669;12801301;0.059867;quickSort
705700;409769843472;443556;13690413;14133969;12803301;0.061091;quickSort
705800;409910993472;443656;13692613;14136269;12805301;0.061347;quickSort
705900;4091052163472;443756;13694813;14138569;12807301;0.061242;quickSort
706000;4091193353472;443856;13697013;14140869;12809301;0.061244;quickSort
706100;410118811280;443956;13699213;14143169;12811301;0.061278;quickSort
706200;410260041280;444056;13701413;14145469;12813301;0.061384;quickSort
706300;410401291280;444156;13703613;14147769;12815301;0.061242;quickSort
706400;410542561280;444256;13705813;14150069;12817301;0.061282;quickSort
706500;410683851280;444356;13708013;14152369;12819301;0.060841;quickSort
706600;410825161280;444456;13710213;14154669;12821301;0.060778;quickSort
706700;410966491280;444556;13712413;14156969;12823301;0.061260;quickSort
706800;4101107841280;444656;13714613;14159269;12825301;0.062058;quickSort
706900;411033459088;444756;13716813;14161569;12827301;0.061345;quickSort
707000;411174849088;444856;13719013;14163869;12829301;0.061558;quickSort
707100;411316259088;444956;13721213;14166169;12831301;0.062100;quickSort
707200;411457689088;445056;13723413;14168469;12833301;0.061993;quickSort
707300;411599139088;445156;13725613;14170769;12835301;0.061427;quickSort
707400;411740609088;445256;13727813;14173069;12837301;0.061430;quickSort
707500;411882099088;445356;13730013;14175369;12839301;0.062046;quickSort
707600;4111023609088;445456;13732213;14177669;12841301;0.061373;quickSort
707700;4111165139088;445556;13734413;14179969;12843301;0.061369;quickSort
707800;412090936896;445656;13736613;14182269;12845301;0.061428;quickSort
707900;412232506896;445756;13738813;14184569;12847301;0.061388;quickSort
708000;412374096896;445856;13741013;14186869;12849301;0.061450;quickSort
708100;412515706896;445956;13743213;14189169;12851301;0.061480;quickSort
708200;412657336896;446056;13745413;14191469;12853301;0.061434;quickSort
708300;412798986896;446156;13747613;14193769;12855301;0.061379;quickSort
708400;412940656896;446256;13749813;14196069;12857301;0.061577;quickSort
708500;4121082346896;446356;13752013;14198369;12859301;0.061484;quickSort
708600;413008304704;446456;13754213;14200669;12861301;0.061391;quickSort
708700;413150034704;446556;13756413;14202969;12863301;0.060115;quickSort
708800;413291784704;446656;13758613;14205269;12865301;0.061435;quickSort
708900;413433554704;446756;13760813;14207569;12867301;0.061517;quickSort
709000;413575344704;446856;13763013;14209869;12869301;0.061631;quickSort
709100;413717154704;446956;13765213;14212169;12871301;0.061414;quickSort
709200;413858984704;447056;13767413;14214469;12873301;0.066391;quickSort
709300;4131000834704;447156;13769613;14216769;12875301;0.061548;quickSort
709400;4131142704704;447256;13771813;14219069;12877301;0.061575;quickSort
709500;414068842512;447356;13774013;14221369;12879301;0.061563;quickSort
709600;414210752512;447456;13776213;14223669;12881301;0.060541;quickSort
709700;414352682512;447556;13778413;14225969;12883301;0.061546;quickSort
709800;414494632512;447656;13780613;14228269;12885301;0.061510;quickSort
709900;414636602512;447756;13782813;14230569;12887301;0.062221;quickSort
710000;414778592512;447856;13785013;14232869;12889301;0.061809;quickSort
710100;414920602512;447956;13787213;14235169;12891301;0.061951;quickSort
710200;4141062632512;448056;13789413;14237469;12893301;0.061894;quickSort
710300;4141204682512;448156;13791613;14239769;12895301;0.061642;quickSort
710400;415131000320;448256;13793813;14242069;12897301;0.061691;quickSort
710500;415273090320;448356;13796013;14244369;12899301;0.061953;quickSort
710600;415415200320;448456;13798213;14246669;12901301;0.061689;quickSort
710700;415557330320;448556;13800413;14248969;12903301;0.061698;quickSort
710800;415699480320;448656;13802613;14251269;12905301;0.060204;quickSort
710900;415841650320;448756;13804813;14253569;12907301;0.061678;quickSort
711000;415983840320;448856;13807013;14255869;12909301;0.061732;quickSort
711100;4151126050320;448956;13809213;14258169;12911301;0.061680;quickSort
711200;416052528128;449056;13811413;14260469;12913301;0.061758;quickSort
711300;416194778128;449156;13813613;14262769;12915301;0.061674;quickSort
711400;416337048128;449256;13815813;14265069;12917301;0.061791;quickSort
711500;416479338128;449356;13818013;14267369;12919301;0.061772;quickSort
711600;416621648128;449456;13820213;14269669;12921301;0.061731;quickSort
711700;416763978128;449556;13822413;14271969;12923301;0.061727;quickSort
711800;416906328128;449656;13824613;14274269;12925301;0.061770;quickSort
711900;4161048698128;449756;13826813;14276569;12927301;0.061811;quickSort
712000;4161191088128;449856;13829013;14278869;12929301;0.061724;quickSort
712100;417117745936;449956;13831213;14281169;12931301;0.061815;quickSort
712200;417260175936;450056;13833413;14283469;12933301;0.061727;quickSort
712300;417402625936;450156;13835613;14285769;12935301;0.061809;quickSort
712400;417545095936;450256;13837813;14288069;12937301;0.062134;quickSort
712500;417687585936;450356;13840013;14290369;12939301;0.061937;quickSort
712600;417830095936;450456;13842213;14292669;12941301;0.062915;quickSort
712700;417972625936;450556;13844413;14294969;12943301;0.061875;quickSort
712800;4171115175936;450656;13846613;14297269;12945301;0.061883;quickSort
712900;418041993744;450756;13848813;14299569;12947301;0.061841;quickSort
713000;418184583744;450856;13851013;14301869;12949301;0.062067;quickSort
713100;418327193744;450956;13853213;14304169;12951301;0.062057;quickSort
713200;418469823744;451056;13855413;14306469;12953301;0.061874;quickSort
713300;418612473744;451156;13857613;14308769;12955301;0.061944;quickSort
713400;418755143744;451256;13859813;14311069;12957301;0.061878;quickSort
713500;418897833744;451356;13862013;14313369;12959301;0.061874;quickSort
713600;4181040543744;451456;13864213;14315669;12961301;0.062623;quickSort
713700;4181183273744;451556;13866413;14317969;12963301;0.061917;quickSort
713800;419110271552;451656;13868613;14320269;12965301;0.061871;quickSort
713900;419253041552;451756;13870813;14322569;12967301;0.061928;quickSort
714000;419395831552;451856;13873013;14324869;12969301;0.061949;quickSort
714100;419538641552;451956;13875213;14327169;12971301;0.061966;quickSort
714200;419681471552;452056;13877413;14329469;12973301;0.063478;quickSort
714300;419824321552;452156;13879613;14331769;12975301;0.061944;quickSort
714400;419967191552;452256;13881813;14334069;12977301;0.061973;quickSort
714500;4191110081552;452356;13884013;14336369;12979301;0.061974;quickSort
714600;420037239360;452456;13886213;14338669;12981301;0.061975;quickSort
714700;420180169360;452556;13888413;14340969;12983301;0.062181;quickSort
714800;420323119360;452656;13890613;14343269;12985301;0.062019;quickSort
714900;420466089360;452756;13892813;14345569;12987301;0.062071;quickSort
715000;420609079360;452856;13895013;14347869;12989301;0.062284;quickSort
715100;420752089360;452956;13897213;14350169;12991301;0.062152;quickSort
715200;420895119360;453056;13899413;14352469;12993301;0.062123;quickSort
715300;4201038169360;453156;13901613;14354769;12995301;0.061089;quickSort
715400;4201181239360;453256;13903813;14357069;12997301;0.061679;quickSort
715500;421108577168;453356;13906013;14359369;12999301;0.062147;quickSort
715600;421251687168;453456;13908213;14361669;13001301;0.062247;quickSort
715700;421394817168;453556;13910413;14363969;13003301;0.062426;quickSort
715800;421537967168;453656;13912613;14366269;13005301;0.062529;quickSort
715900;421681137168;453756;13914813;14368569;13007301;0.062532;quickSort
716000;421824327168;453856;13917013;14370869;13009301;0.062377;quickSort
716100;421967537168;453956;13919213;14373169;13011301;0.061523;quickSort
716200;4211110767168;454056;13921413;14375469;13013301;0.062169;quickSort
716300;422038264976;454156;13923613;14377769;13015301;0.062147;quickSort
716400;422181534976;454256;13925813;14380069;13017301;0.062129;quickSort
716500;422324824976;454356;13928013;14382369;13019301;0.062144;quickSort
716600;422468134976;454456;13930213;14384669;13021301;0.062149;quickSort
716700;422611464976;454556;13932413;14386969;13023301;0.063539;quickSort
716800;422754814976;454656;13934613;14389269;13025301;0.062141;quickSort
716900;422898184976;454756;13936813;14391569;13027301;0.062196;quickSort
717000;4221041574976;454856;13939013;14393869;13029301;0.062184;quickSort
717100;4221184984976;454956;13941213;14396169;13031301;0.062184;quickSort
717200;423112662784;455056;13943413;14398469;13033301;0.062183;quickSort
717300;423256112784;455156;13945613;14400769;13035301;0.062188;quickSort
717400;423399582784;455256;13947813;14403069;13037301;0.062239;quickSort
717500;423543072784;455356;13950013;14405369;13039301;0.062267;quickSort
717600;423686582784;455456;13952213;14407669;13041301;0.062206;quickSort
717700;423830112784;455556;13954413;14409969;13043301;0.062548;quickSort
717800;423973662784;455656;13956613;14412269;13045301;0.062790;quickSort
717900;4231117232784;455756;13958813;14414569;13047301;0.062358;quickSort
718000;424045070592;455856;13961013;14416869;13049301;0.062289;quickSort
718100;424188680592;455956;13963213;14419169;13051301;0.062294;quickSort
718200;424332310592;456056;13965413;14421469;13053301;0.061273;quickSort
718300;424475960592;456156;13967613;14423769;13055301;0.061078;quickSort
718400;424619630592;456256;13969813;14426069;13057301;0.062528;quickSort
718500;424763320592;456356;13972013;14428369;13059301;0.062350;quickSort
718600;424907030592;456456;13974213;14430669;13061301;0.062316;quickSort
718700;4241050760592;456556;13976413;14432969;13063301;0.062384;quickSort
718800;4241194510592;456656;13978613;14435269;13065301;0.062375;quickSort
718900;425122528400;456756;13980813;14437569;13067301;0.062402;quickSort
719000;425266318400;456856;13983013;14439869;13069301;0.062465;quickSort
719100;425410128400;456956;13985213;14442169;13071301;0.062373;quickSort
719200;425553958400;457056;13987413;14444469;13073301;0.062415;quickSort
719300;425697808400;457156;13989613;14446769;13075301;0.062574;quickSort
719400;425841678400;457256;13991813;14449069;13077301;0.062459;quickSort
719500;425985568400;457356;13994013;14451369;13079301;0.062335;quickSort
719600;4251129478400;457456;13996213;14453669;13081301;0.062381;quickSort
719700;426057656208;457556;13998413;14455969;13083301;0.062644;quickSort
719800;426201606208;457656;14000613;14458269;13085301;0.061109;quickSort
719900;426345576208;457756;14002813;14460569;13087301;0.062377;quickSort
720000;426489566208;457856;14005013;14462869;13089301;0.062644;quickSort
720100;426633576208;457956;14007213;14465169;13091301;0.062556;quickSort
720200;426777606208;458056;14009413;14467469;13093301;0.062486;quickSort
720300;426921656208;458156;14011613;14469769;13095301;0.062497;quickSort
720400;4261065726208;458256;14013813;14472069;13097301;0.062507;quickSort
720500;4261209816208;458356;14016013;14474369;13099301;0.062504;quickSort
720600;427138174016;458456;14018213;14476669;13101301;0.062854;quickSort
720700;427282304016;458556;14020413;14478969;13103301;0.062575;quickSort
720800;427426454016;458656;14022613;14481269;13105301;0.062544;quickSort
720900;427570624016;458756;14024813;14483569;13107301;0.062474;quickSort
721000;427714814016;458856;14027013;14485869;13109301;0.062725;quickSort
721100;427859024016;458956;14029213;14488169;13111301;0.062502;quickSort
721200;4271003254016;459056;14031413;14490469;13113301;0.062493;quickSort
721300;4271147504016;459156;14033613;14492769;13115301;0.063305;quickSort
721400;428076021824;459256;14035813;14495069;13117301;0.062584;quickSort
721500;428220311824;459356;14038013;14497369;13119301;0.062553;quickSort
721600;428364621824;459456;14040213;14499669;13121301;0.062616;quickSort
721700;428508951824;459556;14042413;14501969;13123301;0.062656;quickSort
721800;428653301824;459656;14044613;14504269;13125301;0.062880;quickSort
721900;428797671824;459756;14046813;14506569;13127301;0.062742;quickSort
722000;428942061824;459856;14049013;14508869;13129301;0.062596;quickSort
722100;4281086471824;459956;14051213;14511169;13131301;0.062652;quickSort
722200;429015149632;460056;14053413;14513469;13133301;0.062828;quickSort
722300;429159599632;460156;14055613;14515769;13135301;0.062721;quickSort
722400;429304069632;460256;14057813;14518069;13137301;0.062709;quickSort
722500;429448559632;460356;14060013;14520369;13139301;0.061331;quickSort
722600;429593069632;460456;14062213;14522669;13141301;0.063263;quickSort
722700;429737599632;460556;14064413;14524969;13143301;0.062911;quickSort
722800;429882149632;460656;14066613;14527269;13145301;0.063081;quickSort
722900;4291026719632;460756;14068813;14529569;13147301;0.063888;quickSort
723000;4291171309632;460856;14071013;14531869;13149301;0.062978;quickSort
723100;430100167440;460956;14073213;14534169;13151301;0.062919;quickSort
723200;430244797440;461056;14075413;14536469;13153301;0.063075;quickSort
723300;430389447440;461156;14077613;14538769;13155301;0.062800;quickSort
723400;430534117440;461256;14079813;14541069;13157301;0.062849;quickSort
723500;430678807440;461356;14082013;14543369;13159301;0.062892;quickSort
723600;430823517440;461456;14084213;14545669;13161301;0.061330;quickSort
723700;430968247440;461556;14086413;14547969;13163301;0.063059;quickSort
723800;4301112997440;461656;14088613;14550269;13165301;0.063306;quickSort
723900;431042015248;461756;14090813;14552569;13167301;0.062933;quickSort
724000;431186805248;461856;14093013;14554869;13169301;0.062977;quickSort
724100;431331615248;461956;14095213;14557169;13171301;0.062907;quickSort
724200;431476445248;462056;14097413;14559469;13173301;0.062830;quickSort
724300;431621295248;462156;14099613;14561769;13175301;0.062895;quickSort
724400;431766165248;462256;14101813;14564069;13177301;0.062830;quickSort
