Кол-во элементов;Кол-во элементов в ^ 2;Кол-во перестановок;Кол-во сравнений;Сумма сравнений и перестановок;Кол-во итераций;Время на сортировку;Тип сортировки
0;0;0;2;2;0;0.000002;quickSort
100;10000;63;669;732;543;0.000008;quickSort
200;40000;127;1534;1661;1280;0.000014;quickSort
300;90000;172;2414;2586;2070;0.000019;quickSort
400;160000;255;3463;3718;2953;0.000028;quickSort
500;250000;255;4263;4518;3753;0.000032;quickSort
600;360000;344;5419;5763;4731;0.000040;quickSort
700;490000;444;6619;7063;5731;0.000050;quickSort
800;640000;511;7720;8231;6698;0.000061;quickSort
900;810000;511;8620;9131;7598;0.000062;quickSort
1000;1000000;511;9520;10031;8498;0.000057;quickSort
1100;1210000;588;10728;11316;9552;0.000064;quickSort
1200;1440000;688;12028;12716;10652;0.000073;quickSort
1300;1690000;788;13328;14116;11752;0.000088;quickSort
1400;1960000;888;14628;15516;12852;0.000101;quickSort
1500;2250000;988;15928;16916;13952;0.000220;quickSort
1600;2560000;1023;17033;18056;14987;0.000115;quickSort
1700;2890000;1023;18033;19056;15987;0.000142;quickSort
1800;3240000;1023;19033;20056;16987;0.000133;quickSort
1900;3610000;1023;20033;21056;17987;0.000115;quickSort
2000;4000000;1023;21033;22056;18987;0.000140;quickSort
2100;4410000;1076;22245;23321;20093;0.000152;quickSort
2200;4840000;1176;23645;24821;21293;0.000162;quickSort
2300;5290000;1276;25045;26321;22493;0.000171;quickSort
2400;5760000;1376;26445;27821;23693;0.000157;quickSort
2500;6250000;1476;27845;29321;24893;0.000183;quickSort
2600;6760000;1576;29245;30821;26093;0.000171;quickSort
2700;7290000;1676;30645;32321;27293;0.000183;quickSort
2800;7840000;1776;32045;33821;28493;0.000223;quickSort
2900;8410000;1876;33445;35321;29693;0.000236;quickSort
3000;9000000;1976;34845;36821;30893;0.000219;quickSort
3100;9610000;2047;36158;38205;32064;0.000214;quickSort
3200;10240000;2047;37258;39305;33164;0.000235;quickSort
3300;10890000;2047;38358;40405;34264;0.000252;quickSort
3400;11560000;2047;39458;41505;35364;0.000287;quickSort
3500;12250000;2047;40558;42605;36464;0.000272;quickSort
3600;12960000;2047;41658;43705;37564;0.000293;quickSort
3700;13690000;2047;42758;44805;38664;0.000282;quickSort
3800;14440000;2047;43858;45905;39764;0.000252;quickSort
3900;15210000;2047;44958;47005;40864;0.000301;quickSort
4000;16000000;2047;46058;48105;41964;0.000268;quickSort
4100;16810000;2052;47178;49230;43074;0.000333;quickSort
4200;17640000;2152;48678;50830;44374;0.000319;quickSort
4300;18490000;2252;50178;52430;45674;0.000320;quickSort
4400;19360000;2352;51678;54030;46974;0.000339;quickSort
4500;20250000;2452;53178;55630;48274;0.000299;quickSort
4600;21160000;2552;54678;57230;49574;0.000366;quickSort
4700;22090000;2652;56178;58830;50874;0.000400;quickSort
4800;23040000;2752;57678;60430;52174;0.000388;quickSort
4900;24010000;2852;59178;62030;53474;0.000390;quickSort
5000;25000000;2952;60678;63630;54774;0.000355;quickSort
5100;26010000;3052;62178;65230;56074;0.000349;quickSort
5200;27040000;3152;63678;66830;57374;0.000440;quickSort
5300;28090000;3252;65178;68430;58674;0.000439;quickSort
5400;29160000;3352;66678;70030;59974;0.000453;quickSort
5500;30250000;3452;68178;71630;61274;0.000467;quickSort
5600;31360000;3552;69678;73230;62574;0.000411;quickSort
5700;32490000;3652;71178;74830;63874;0.000510;quickSort
5800;33640000;3752;72678;76430;65174;0.000450;quickSort
5900;34810000;3852;74178;78030;66474;0.000527;quickSort
6000;36000000;3952;75678;79630;67774;0.000495;quickSort
6100;37210000;4052;77178;81230;69074;0.000438;quickSort
6200;38440000;4095;78507;82602;70317;0.000492;quickSort
6300;39690000;4095;79707;83802;71517;0.000465;quickSort
6400;40960000;4095;80907;85002;72717;0.000478;quickSort
6500;42250000;4095;82107;86202;73917;0.000552;quickSort
6600;43560000;4095;83307;87402;75117;0.000488;quickSort
6700;44890000;4095;84507;88602;76317;0.000488;quickSort
6800;46240000;4095;85707;89802;77517;0.000498;quickSort
6900;47610000;4095;86907;91002;78717;0.000580;quickSort
7000;49000000;4095;88107;92202;79917;0.000595;quickSort
7100;50410000;4095;89307;93402;81117;0.000598;quickSort
7200;51840000;4095;90507;94602;82317;0.000575;quickSort
7300;53290000;4095;91707;95802;83517;0.000597;quickSort
7400;54760000;4095;92907;97002;84717;0.000587;quickSort
7500;56250000;4095;94107;98202;85917;0.000606;quickSort
7600;57760000;4095;95307;99402;87117;0.000571;quickSort
7700;59290000;4095;96507;100602;88317;0.000627;quickSort
7800;60840000;4095;97707;101802;89517;0.000616;quickSort
7900;62410000;4095;98907;103002;90717;0.000688;quickSort
8000;64000000;4095;100107;104202;91917;0.000698;quickSort
8100;65610000;4095;101307;105402;93117;0.000549;quickSort
8200;67240000;4104;102543;106647;94335;0.000612;quickSort
8300;68890000;4204;104143;108347;95735;0.000648;quickSort
8400;70560000;4304;105743;110047;97135;0.000621;quickSort
8500;72250000;4404;107343;111747;98535;0.000593;quickSort
8600;73960000;4504;108943;113447;99935;0.000690;quickSort
8700;75690000;4604;110543;115147;101335;0.000700;quickSort
8800;77440000;4704;112143;116847;102735;0.000638;quickSort
8900;79210000;4804;113743;118547;104135;0.000729;quickSort
9000;81000000;4904;115343;120247;105535;0.000696;quickSort
9100;82810000;5004;116943;121947;106935;0.000696;quickSort
9200;84640000;5104;118543;123647;108335;0.000661;quickSort
9300;86490000;5204;120143;125347;109735;0.000766;quickSort
9400;88360000;5304;121743;127047;111135;0.000881;quickSort
9500;90250000;5404;123343;128747;112535;0.001124;quickSort
9600;92160000;5504;124943;130447;113935;0.001178;quickSort
9700;94090000;5604;126543;132147;115335;0.000830;quickSort
9800;96040000;5704;128143;133847;116735;0.001006;quickSort
9900;98010000;5804;129743;135547;118135;0.001486;quickSort
10000;100000000;5904;131343;137247;119535;0.000862;quickSort
10100;102010000;6004;132943;138947;120935;0.000938;quickSort
10200;104040000;6104;134543;140647;122335;0.000977;quickSort
10300;106090000;6204;136143;142347;123735;0.000951;quickSort
10400;108160000;6304;137743;144047;125135;0.000864;quickSort
10500;110250000;6404;139343;145747;126535;0.000824;quickSort
10600;112360000;6504;140943;147447;127935;0.000909;quickSort
10700;114490000;6604;142543;149147;129335;0.000917;quickSort
10800;116640000;6704;144143;150847;130735;0.000829;quickSort
10900;118810000;6804;145743;152547;132135;0.000896;quickSort
11000;121000000;6904;147343;154247;133535;0.001011;quickSort
11100;123210000;7004;148943;155947;134935;0.001396;quickSort
11200;125440000;7104;150543;157647;136335;0.000839;quickSort
11300;127690000;7204;152143;159347;137735;0.001298;quickSort
11400;129960000;7304;153743;161047;139135;0.000979;quickSort
11500;132250000;7404;155343;162747;140535;0.000937;quickSort
11600;134560000;7504;156943;164447;141935;0.000901;quickSort
11700;136890000;7604;158543;166147;143335;0.001085;quickSort
11800;139240000;7704;160143;167847;144735;0.001065;quickSort
11900;141610000;7804;161743;169547;146135;0.000912;quickSort
12000;144000000;7904;163343;171247;147535;0.001079;quickSort
12100;146410000;8004;164943;172947;148935;0.001078;quickSort
12200;148840000;8104;166543;174647;150335;0.001133;quickSort
12300;151290000;8191;168104;176295;151722;0.001039;quickSort
12400;153760000;8191;169404;177595;153022;0.000972;quickSort
12500;156250000;8191;170704;178895;154322;0.000979;quickSort
12600;158760000;8191;172004;180195;155622;0.001973;quickSort
12700;161290000;8191;173304;181495;156922;0.001402;quickSort
12800;163840000;8191;174604;182795;158222;0.001121;quickSort
12900;166410000;8191;175904;184095;159522;0.001007;quickSort
13000;169000000;8191;177204;185395;160822;0.001019;quickSort
13100;171610000;8191;178504;186695;162122;0.001307;quickSort
13200;174240000;8191;179804;187995;163422;0.001136;quickSort
13300;176890000;8191;181104;189295;164722;0.001195;quickSort
13400;179560000;8191;182404;190595;166022;0.001208;quickSort
13500;182250000;8191;183704;191895;167322;0.001202;quickSort
13600;184960000;8191;185004;193195;168622;0.001066;quickSort
13700;187690000;8191;186304;194495;169922;0.001320;quickSort
13800;190440000;8191;187604;195795;171222;0.001302;quickSort
13900;193210000;8191;188904;197095;172522;0.001249;quickSort
14000;196000000;8191;190204;198395;173822;0.001162;quickSort
14100;198810000;8191;191504;199695;175122;0.001235;quickSort
14200;201640000;8191;192804;200995;176422;0.001374;quickSort
14300;204490000;8191;194104;202295;177722;0.001103;quickSort
14400;207360000;8191;195404;203595;179022;0.001194;quickSort
14500;210250000;8191;196704;204895;180322;0.001088;quickSort
14600;213160000;8191;198004;206195;181622;0.001414;quickSort
14700;216090000;8191;199304;207495;182922;0.001511;quickSort
14800;219040000;8191;200604;208795;184222;0.001174;quickSort
14900;222010000;8191;201904;210095;185522;0.001373;quickSort
15000;225000000;8191;203204;211395;186822;0.002078;quickSort
15100;228010000;8191;204504;212695;188122;0.001386;quickSort
15200;231040000;8191;205804;213995;189422;0.001164;quickSort
15300;234090000;8191;207104;215295;190722;0.001181;quickSort
15400;237160000;8191;208404;216595;192022;0.001449;quickSort
15500;240250000;8191;209704;217895;193322;0.001307;quickSort
15600;243360000;8191;211004;219195;194622;0.001209;quickSort
15700;246490000;8191;212304;220495;195922;0.001160;quickSort
15800;249640000;8191;213604;221795;197222;0.001381;quickSort
15900;252810000;8191;214904;223095;198522;0.001448;quickSort
16000;256000000;8191;216204;224395;199822;0.001238;quickSort
16100;259210000;8191;217504;225695;201122;0.001221;quickSort
16200;262440000;8191;218804;226995;202422;0.001215;quickSort
16300;265690000;8191;220104;228295;203722;0.002815;quickSort
16400;268960000;8208;221472;229680;205056;0.001387;quickSort
16500;272250000;8308;223172;231480;206556;0.001309;quickSort
16600;275560000;8408;224872;233280;208056;0.001231;quickSort
16700;278890000;8508;226572;235080;209556;0.001217;quickSort
16800;282240000;8608;228272;236880;211056;0.001471;quickSort
16900;285610000;8708;229972;238680;212556;0.001920;quickSort
17000;289000000;8808;231672;240480;214056;0.001269;quickSort
17100;292410000;8908;233372;242280;215556;0.001889;quickSort
17200;295840000;9008;235072;244080;217056;0.001443;quickSort
17300;299290000;9108;236772;245880;218556;0.001371;quickSort
17400;302760000;9208;238472;247680;220056;0.001398;quickSort
17500;306250000;9308;240172;249480;221556;0.001501;quickSort
17600;309760000;9408;241872;251280;223056;0.001411;quickSort
17700;313290000;9508;243572;253080;224556;0.001577;quickSort
17800;316840000;9608;245272;254880;226056;0.001367;quickSort
17900;320410000;9708;246972;256680;227556;0.001575;quickSort
18000;324000000;9808;248672;258480;229056;0.001661;quickSort
18100;327610000;9908;250372;260280;230556;0.001937;quickSort
18200;331240000;10008;252072;262080;232056;0.001605;quickSort
18300;334890000;10108;253772;263880;233556;0.001784;quickSort
18400;338560000;10208;255472;265680;235056;0.001709;quickSort
18500;342250000;10308;257172;267480;236556;0.001499;quickSort
18600;345960000;10408;258872;269280;238056;0.001489;quickSort
18700;349690000;10508;260572;271080;239556;0.001433;quickSort
18800;353440000;10608;262272;272880;241056;0.001700;quickSort
18900;357210000;10708;263972;274680;242556;0.001830;quickSort
19000;361000000;10808;265672;276480;244056;0.002140;quickSort
19100;364810000;10908;267372;278280;245556;0.001930;quickSort
19200;368640000;11008;269072;280080;247056;0.001704;quickSort
19300;372490000;11108;270772;281880;248556;0.001889;quickSort
19400;376360000;11208;272472;283680;250056;0.001914;quickSort
19500;380250000;11308;274172;285480;251556;0.001816;quickSort
19600;384160000;11408;275872;287280;253056;0.005336;quickSort
19700;388090000;11508;277572;289080;254556;0.001732;quickSort
19800;392040000;11608;279272;290880;256056;0.002581;quickSort
19900;396010000;11708;280972;292680;257556;0.001838;quickSort
20000;400000000;11808;282672;294480;259056;0.001620;quickSort
20100;404010000;11908;284372;296280;260556;0.002306;quickSort
20200;408040000;12008;286072;298080;262056;0.001764;quickSort
20300;412090000;12108;287772;299880;263556;0.001882;quickSort
20400;416160000;12208;289472;301680;265056;0.001675;quickSort
20500;420250000;12308;291172;303480;266556;0.001923;quickSort
20600;424360000;12408;292872;305280;268056;0.001760;quickSort
20700;428490000;12508;294572;307080;269556;0.001649;quickSort
20800;432640000;12608;296272;308880;271056;0.002217;quickSort
20900;436810000;12708;297972;310680;272556;0.001875;quickSort
21000;441000000;12808;299672;312480;274056;0.001721;quickSort
21100;445210000;12908;301372;314280;275556;0.001751;quickSort
21200;449440000;13008;303072;316080;277056;0.001889;quickSort
21300;453690000;13108;304772;317880;278556;0.001848;quickSort
21400;457960000;13208;306472;319680;280056;0.001751;quickSort
21500;462250000;13308;308172;321480;281556;0.001999;quickSort
21600;466560000;13408;309872;323280;283056;0.001848;quickSort
21700;470890000;13508;311572;325080;284556;0.001978;quickSort
21800;475240000;13608;313272;326880;286056;0.002014;quickSort
21900;479610000;13708;314972;328680;287556;0.001778;quickSort
22000;484000000;13808;316672;330480;289056;0.002053;quickSort
22100;488410000;13908;318372;332280;290556;0.002000;quickSort
22200;492840000;14008;320072;334080;292056;0.002121;quickSort
22300;497290000;14108;321772;335880;293556;0.002274;quickSort
22400;501760000;14208;323472;337680;295056;0.002212;quickSort
22500;506250000;14308;325172;339480;296556;0.002174;quickSort
22600;510760000;14408;326872;341280;298056;0.002095;quickSort
22700;515290000;14508;328572;343080;299556;0.002408;quickSort
22800;519840000;14608;330272;344880;301056;0.004261;quickSort
22900;524410000;14708;331972;346680;302556;0.002234;quickSort
23000;529000000;14808;333672;348480;304056;0.001956;quickSort
23100;533610000;14908;335372;350280;305556;0.001839;quickSort
23200;538240000;15008;337072;352080;307056;0.001983;quickSort
23300;542890000;15108;338772;353880;308556;0.002393;quickSort
23400;547560000;15208;340472;355680;310056;0.002045;quickSort
23500;552250000;15308;342172;357480;311556;0.001883;quickSort
23600;556960000;15408;343872;359280;313056;0.002173;quickSort
23700;561690000;15508;345572;361080;314556;0.002178;quickSort
23800;566440000;15608;347272;362880;316056;0.002147;quickSort
23900;571210000;15708;348972;364680;317556;0.001979;quickSort
24000;576000000;15808;350672;366480;319056;0.002094;quickSort
24100;580810000;15908;352372;368280;320556;0.002028;quickSort
24200;585640000;16008;354072;370080;322056;0.002371;quickSort
24300;590490000;16108;355772;371880;323556;0.002136;quickSort
24400;595360000;16208;357472;373680;325056;0.002176;quickSort
24500;600250000;16308;359172;375480;326556;0.002591;quickSort
24600;605160000;16383;360797;377180;328031;0.002965;quickSort
24700;610090000;16383;362197;378580;329431;0.002060;quickSort
24800;615040000;16383;363597;379980;330831;0.002391;quickSort
24900;620010000;16383;364997;381380;332231;0.002137;quickSort
25000;625000000;16383;366397;382780;333631;0.002193;quickSort
25100;630010000;16383;367797;384180;335031;0.002067;quickSort
25200;635040000;16383;369197;385580;336431;0.002084;quickSort
25300;640090000;16383;370597;386980;337831;0.002240;quickSort
25400;645160000;16383;371997;388380;339231;0.002068;quickSort
25500;650250000;16383;373397;389780;340631;0.002448;quickSort
25600;655360000;16383;374797;391180;342031;0.002143;quickSort
25700;660490000;16383;376197;392580;343431;0.002133;quickSort
25800;665640000;16383;377597;393980;344831;0.002302;quickSort
25900;670810000;16383;378997;395380;346231;0.002302;quickSort
26000;676000000;16383;380397;396780;347631;0.002479;quickSort
26100;681210000;16383;381797;398180;349031;0.002154;quickSort
26200;686440000;16383;383197;399580;350431;0.002442;quickSort
26300;691690000;16383;384597;400980;351831;0.002246;quickSort
26400;696960000;16383;385997;402380;353231;0.002322;quickSort
26500;702250000;16383;387397;403780;354631;0.002413;quickSort
26600;707560000;16383;388797;405180;356031;0.002197;quickSort
26700;712890000;16383;390197;406580;357431;0.002228;quickSort
26800;718240000;16383;391597;407980;358831;0.002578;quickSort
26900;723610000;16383;392997;409380;360231;0.002231;quickSort
27000;729000000;16383;394397;410780;361631;0.002347;quickSort
27100;734410000;16383;395797;412180;363031;0.002475;quickSort
27200;739840000;16383;397197;413580;364431;0.002284;quickSort
27300;745290000;16383;398597;414980;365831;0.002319;quickSort
27400;750760000;16383;399997;416380;367231;0.002263;quickSort
27500;756250000;16383;401397;417780;368631;0.002572;quickSort
27600;761760000;16383;402797;419180;370031;0.002246;quickSort
27700;767290000;16383;404197;420580;371431;0.002338;quickSort
27800;772840000;16383;405597;421980;372831;0.002830;quickSort
27900;778410000;16383;406997;423380;374231;0.002260;quickSort
28000;784000000;16383;408397;424780;375631;0.002313;quickSort
28100;789610000;16383;409797;426180;377031;0.002266;quickSort
28200;795240000;16383;411197;427580;378431;0.002509;quickSort
28300;800890000;16383;412597;428980;379831;0.002589;quickSort
28400;806560000;16383;413997;430380;381231;0.002422;quickSort
28500;812250000;16383;415397;431780;382631;0.002384;quickSort
28600;817960000;16383;416797;433180;384031;0.003046;quickSort
28700;823690000;16383;418197;434580;385431;0.002638;quickSort
28800;829440000;16383;419597;435980;386831;0.002490;quickSort
28900;835210000;16383;420997;437380;388231;0.002321;quickSort
29000;841000000;16383;422397;438780;389631;0.002870;quickSort
29100;846810000;16383;423797;440180;391031;0.002477;quickSort
29200;852640000;16383;425197;441580;392431;0.002416;quickSort
29300;858490000;16383;426597;442980;393831;0.002337;quickSort
29400;864360000;16383;427997;444380;395231;0.002351;quickSort
29500;870250000;16383;429397;445780;396631;0.002552;quickSort
29600;876160000;16383;430797;447180;398031;0.003096;quickSort
29700;882090000;16383;432197;448580;399431;0.002365;quickSort
29800;888040000;16383;433597;449980;400831;0.002928;quickSort
29900;894010000;16383;434997;451380;402231;0.002499;quickSort
30000;900000000;16383;436397;452780;403631;0.002405;quickSort
30100;906010000;16383;437797;454180;405031;0.002421;quickSort
30200;912040000;16383;439197;455580;406431;0.002418;quickSort
30300;918090000;16383;440597;456980;407831;0.002436;quickSort
30400;924160000;16383;441997;458380;409231;0.002507;quickSort
30500;930250000;16383;443397;459780;410631;0.002418;quickSort
30600;936360000;16383;444797;461180;412031;0.002425;quickSort
30700;942490000;16383;446197;462580;413431;0.002411;quickSort
30800;948640000;16383;447597;463980;414831;0.002448;quickSort
30900;954810000;16383;448997;465380;416231;0.002437;quickSort
31000;961000000;16383;450397;466780;417631;0.002436;quickSort
31100;967210000;16383;451797;468180;419031;0.002445;quickSort
31200;973440000;16383;453197;469580;420431;0.002450;quickSort
31300;979690000;16383;454597;470980;421831;0.002807;quickSort
31400;985960000;16383;455997;472380;423231;0.002480;quickSort
31500;992250000;16383;457397;473780;424631;0.002475;quickSort
31600;998560000;16383;458797;475180;426031;0.002495;quickSort
31700;1004890000;16383;460197;476580;427431;0.002498;quickSort
31800;1011240000;16383;461597;477980;428831;0.002492;quickSort
31900;1017610000;16383;462997;479380;430231;0.002554;quickSort
32000;1024000000;16383;464397;480780;431631;0.002712;quickSort
32100;1030410000;16383;465797;482180;433031;0.002505;quickSort
32200;1036840000;16383;467197;483580;434431;0.002509;quickSort
32300;1043290000;16383;468597;484980;435831;0.002555;quickSort
32400;1049760000;16383;469997;486380;437231;0.002618;quickSort
32500;1056250000;16383;471397;487780;438631;0.002531;quickSort
32600;1062760000;16383;472797;489180;440031;0.002762;quickSort
32700;1069290000;16383;474197;490580;441431;0.002545;quickSort
32800;1075840000;16416;475729;492145;442897;0.002614;quickSort
32900;1082410000;16516;477529;494045;444497;0.002586;quickSort
33000;1089000000;16616;479329;495945;446097;0.003089;quickSort
33100;1095610000;16716;481129;497845;447697;0.003405;quickSort
33200;1102240000;16816;482929;499745;449297;0.002967;quickSort
33300;1108890000;16916;484729;501645;450897;0.003250;quickSort
33400;1115560000;17016;486529;503545;452497;0.003066;quickSort
33500;1122250000;17116;488329;505445;454097;0.003021;quickSort
33600;1128960000;17216;490129;507345;455697;0.002927;quickSort
33700;1135690000;17316;491929;509245;457297;0.003590;quickSort
33800;1142440000;17416;493729;511145;458897;0.002916;quickSort
33900;1149210000;17516;495529;513045;460497;0.002946;quickSort
34000;1156000000;17616;497329;514945;462097;0.002664;quickSort
34100;1162810000;17716;499129;516845;463697;0.003041;quickSort
34200;1169640000;17816;500929;518745;465297;0.002853;quickSort
34300;1176490000;17916;502729;520645;466897;0.002727;quickSort
34400;1183360000;18016;504529;522545;468497;0.002833;quickSort
34500;1190250000;18116;506329;524445;470097;0.002753;quickSort
34600;1197160000;18216;508129;526345;471697;0.003061;quickSort
34700;1204090000;18316;509929;528245;473297;0.002773;quickSort
34800;1211040000;18416;511729;530145;474897;0.003500;quickSort
34900;1218010000;18516;513529;532045;476497;0.002976;quickSort
35000;1225000000;18616;515329;533945;478097;0.002730;quickSort
35100;1232010000;18716;517129;535845;479697;0.002748;quickSort
35200;1239040000;18816;518929;537745;481297;0.002816;quickSort
35300;1246090000;18916;520729;539645;482897;0.003025;quickSort
35400;1253160000;19016;522529;541545;484497;0.002856;quickSort
35500;1260250000;19116;524329;543445;486097;0.002856;quickSort
35600;1267360000;19216;526129;545345;487697;0.002427;quickSort
35700;1274490000;19316;527929;547245;489297;0.002863;quickSort
35800;1281640000;19416;529729;549145;490897;0.002786;quickSort
35900;1288810000;19516;531529;551045;492497;0.002434;quickSort
36000;1296000000;19616;533329;552945;494097;0.002437;quickSort
36100;1303210000;19716;535129;554845;495697;0.002430;quickSort
36200;1310440000;19816;536929;556745;497297;0.003342;quickSort
36300;1317690000;19916;538729;558645;498897;0.002584;quickSort
36400;1324960000;20016;540529;560545;500497;0.002636;quickSort
36500;1332250000;20116;542329;562445;502097;0.002975;quickSort
36600;1339560000;20216;544129;564345;503697;0.002528;quickSort
36700;1346890000;20316;545929;566245;505297;0.002557;quickSort
36800;1354240000;20416;547729;568145;506897;0.002872;quickSort
36900;1361610000;20516;549529;570045;508497;0.002500;quickSort
37000;1369000000;20616;551329;571945;510097;0.002605;quickSort
37100;1376410000;20716;553129;573845;511697;0.002878;quickSort
37200;1383840000;20816;554929;575745;513297;0.002514;quickSort
37300;1391290000;20916;556729;577645;514897;0.002540;quickSort
37400;1398760000;21016;558529;579545;516497;0.002532;quickSort
37500;1406250000;21116;560329;581445;518097;0.003409;quickSort
37600;1413760000;21216;562129;583345;519697;0.002574;quickSort
37700;1421290000;21316;563929;585245;521297;0.002578;quickSort
37800;1428840000;21416;565729;587145;522897;0.002576;quickSort
37900;1436410000;21516;567529;589045;524497;0.002607;quickSort
38000;1444000000;21616;569329;590945;526097;0.003078;quickSort
38100;1451610000;21716;571129;592845;527697;0.003430;quickSort
38200;1459240000;21816;572929;594745;529297;0.002616;quickSort
38300;1466890000;21916;574729;596645;530897;0.002614;quickSort
38400;1474560000;22016;576529;598545;532497;0.003313;quickSort
38500;1482250000;22116;578329;600445;534097;0.002632;quickSort
38600;1489960000;22216;580129;602345;535697;0.002776;quickSort
38700;1497690000;22316;581929;604245;537297;0.002646;quickSort
38800;1505440000;22416;583729;606145;538897;0.002871;quickSort
38900;1513210000;22516;585529;608045;540497;0.002674;quickSort
39000;1521000000;22616;587329;609945;542097;0.002718;quickSort
39100;1528810000;22716;589129;611845;543697;0.002943;quickSort
39200;1536640000;22816;590929;613745;545297;0.002698;quickSort
39300;1544490000;22916;592729;615645;546897;0.002716;quickSort
39400;1552360000;23016;594529;617545;548497;0.002736;quickSort
39500;1560250000;23116;596329;619445;550097;0.002717;quickSort
39600;1568160000;23216;598129;621345;551697;0.002739;quickSort
39700;1576090000;23316;599929;623245;553297;0.002757;quickSort
39800;1584040000;23416;601729;625145;554897;0.002818;quickSort
39900;1592010000;23516;603529;627045;556497;0.002973;quickSort
40000;1600000000;23616;605329;628945;558097;0.002976;quickSort
40100;1608010000;23716;607129;630845;559697;0.002937;quickSort
40200;1616040000;23816;608929;632745;561297;0.002818;quickSort
40300;1624090000;23916;610729;634645;562897;0.002822;quickSort
40400;1632160000;24016;612529;636545;564497;0.003196;quickSort
40500;1640250000;24116;614329;638445;566097;0.002823;quickSort
40600;1648360000;24216;616129;640345;567697;0.002841;quickSort
40700;1656490000;24316;617929;642245;569297;0.003143;quickSort
40800;1664640000;24416;619729;644145;570897;0.002833;quickSort
40900;1672810000;24516;621529;646045;572497;0.002849;quickSort
41000;1681000000;24616;623329;647945;574097;0.002853;quickSort
41100;1689210000;24716;625129;649845;575697;0.003217;quickSort
41200;1697440000;24816;626929;651745;577297;0.002874;quickSort
41300;1705690000;24916;628729;653645;578897;0.003211;quickSort
41400;1713960000;25016;630529;655545;580497;0.002894;quickSort
41500;1722250000;25116;632329;657445;582097;0.002900;quickSort
41600;1730560000;25216;634129;659345;583697;0.004495;quickSort
41700;1738890000;25316;635929;661245;585297;0.002921;quickSort
41800;1747240000;25416;637729;663145;586897;0.002941;quickSort
41900;1755610000;25516;639529;665045;588497;0.003558;quickSort
42000;1764000000;25616;641329;666945;590097;0.002967;quickSort
42100;1772410000;25716;643129;668845;591697;0.003747;quickSort
42200;1780840000;25816;644929;670745;593297;0.002980;quickSort
42300;1789290000;25916;646729;672645;594897;0.002987;quickSort
42400;1797760000;26016;648529;674545;596497;0.003404;quickSort
42500;1806250000;26116;650329;676445;598097;0.003086;quickSort
42600;1814760000;26216;652129;678345;599697;0.003486;quickSort
42700;1823290000;26316;653929;680245;601297;0.004269;quickSort
42800;1831840000;26416;655729;682145;602897;0.003032;quickSort
42900;1840410000;26516;657529;684045;604497;0.003048;quickSort
43000;1849000000;26616;659329;685945;606097;0.003209;quickSort
43100;1857610000;26716;661129;687845;607697;0.003074;quickSort
43200;1866240000;26816;662929;689745;609297;0.003755;quickSort
43300;1874890000;26916;664729;691645;610897;0.003085;quickSort
43400;1883560000;27016;666529;693545;612497;0.003093;quickSort
43500;1892250000;27116;668329;695445;614097;0.003085;quickSort
43600;1900960000;27216;670129;697345;615697;0.003966;quickSort
43700;1909690000;27316;671929;699245;617297;0.003785;quickSort
43800;1918440000;27416;673729;701145;618897;0.003153;quickSort
43900;1927210000;27516;675529;703045;620497;0.003158;quickSort
44000;1936000000;27616;677329;704945;622097;0.003641;quickSort
44100;1944810000;27716;679129;706845;623697;0.003211;quickSort
44200;1953640000;27816;680929;708745;625297;0.003218;quickSort
44300;1962490000;27916;682729;710645;626897;0.003199;quickSort
44400;1971360000;28016;684529;712545;628497;0.003678;quickSort
44500;1980250000;28116;686329;714445;630097;0.003816;quickSort
44600;1989160000;28216;688129;716345;631697;0.003199;quickSort
44700;1998090000;28316;689929;718245;633297;0.003582;quickSort
44800;2007040000;28416;691729;720145;634897;0.004324;quickSort
44900;2016010000;28516;693529;722045;636497;0.003206;quickSort
45000;2025000000;28616;695329;723945;638097;0.003801;quickSort
45100;2034010000;28716;697129;725845;639697;0.003279;quickSort
45200;2043040000;28816;698929;727745;641297;0.004560;quickSort
45300;2052090000;28916;700729;729645;642897;0.004346;quickSort
45400;2061160000;29016;702529;731545;644497;0.004559;quickSort
45500;2070250000;29116;704329;733445;646097;0.003906;quickSort
45600;2079360000;29216;706129;735345;647697;0.003899;quickSort
45700;2088490000;29316;707929;737245;649297;0.003971;quickSort
45800;2097640000;29416;709729;739145;650897;0.004526;quickSort
45900;2106810000;29516;711529;741045;652497;0.003939;quickSort
46000;2116000000;29616;713329;742945;654097;0.004547;quickSort
46100;2125210000;29716;715129;744845;655697;0.003979;quickSort
46200;2134440000;29816;716929;746745;657297;0.004216;quickSort
46300;2143690000;29916;718729;748645;658897;0.003985;quickSort
46400;2152960000;30016;720529;750545;660497;0.004006;quickSort
46500;2162250000;30116;722329;752445;662097;0.004040;quickSort
46600;2171560000;30216;724129;754345;663697;0.004023;quickSort
46700;2180890000;30316;725929;756245;665297;0.004051;quickSort
46800;2190240000;30416;727729;758145;666897;0.004105;quickSort
46900;2199610000;30516;729529;760045;668497;0.004054;quickSort
47000;2209000000;30616;731329;761945;670097;0.004649;quickSort
47100;2218410000;30716;733129;763845;671697;0.004084;quickSort
47200;2227840000;30816;734929;765745;673297;0.004092;quickSort
47300;2237290000;30916;736729;767645;674897;0.004106;quickSort
47400;2246760000;31016;738529;769545;676497;0.004183;quickSort
47500;2256250000;31116;740329;771445;678097;0.004120;quickSort
47600;2265760000;31216;742129;773345;679697;0.004131;quickSort
47700;2275290000;31316;743929;775245;681297;0.004202;quickSort
47800;2284840000;31416;745729;777145;682897;0.004195;quickSort
47900;2294410000;31516;747529;779045;684497;0.004376;quickSort
48000;2304000000;31616;749329;780945;686097;0.004353;quickSort
48100;2313610000;31716;751129;782845;687697;0.004183;quickSort
48200;2323240000;31816;752929;784745;689297;0.004196;quickSort
48300;2332890000;31916;754729;786645;690897;0.004197;quickSort
48400;2342560000;32016;756529;788545;692497;0.004236;quickSort
48500;2352250000;32116;758329;790445;694097;0.004219;quickSort
48600;2361960000;32216;760129;792345;695697;0.004310;quickSort
48700;2371690000;32316;761929;794245;697297;0.004319;quickSort
48800;2381440000;32416;763729;796145;698897;0.004273;quickSort
48900;2391210000;32516;765529;798045;700497;0.004287;quickSort
49000;2401000000;32616;767329;799945;702097;0.004267;quickSort
49100;2410810000;32716;769129;801845;703697;0.004278;quickSort
49200;2420640000;32767;770782;803549;705248;0.004428;quickSort
49300;2430490000;32767;772282;805049;706748;0.004325;quickSort
49400;2440360000;32767;773782;806549;708248;0.004312;quickSort
49500;2450250000;32767;775282;808049;709748;0.004347;quickSort
49600;2460160000;32767;776782;809549;711248;0.004334;quickSort
49700;2470090000;32767;778282;811049;712748;0.004914;quickSort
49800;2480040000;32767;779782;812549;714248;0.004351;quickSort
49900;2490010000;32767;781282;814049;715748;0.005709;quickSort
50000;2500000000;32767;782782;815549;717248;0.004381;quickSort
50100;2510010000;32767;784282;817049;718748;0.004397;quickSort
50200;2520040000;32767;785782;818549;720248;0.004820;quickSort
50300;2530090000;32767;787282;820049;721748;0.004389;quickSort
50400;2540160000;32767;788782;821549;723248;0.004502;quickSort
50500;2550250000;32767;790282;823049;724748;0.004434;quickSort
50600;2560360000;32767;791782;824549;726248;0.004422;quickSort
50700;2570490000;32767;793282;826049;727748;0.005036;quickSort
50800;2580640000;32767;794782;827549;729248;0.004451;quickSort
50900;2590810000;32767;796282;829049;730748;0.004452;quickSort
51000;2601000000;32767;797782;830549;732248;0.004436;quickSort
51100;2611210000;32767;799282;832049;733748;0.004565;quickSort
51200;2621440000;32767;800782;833549;735248;0.004507;quickSort
51300;2631690000;32767;802282;835049;736748;0.004789;quickSort
51400;2641960000;32767;803782;836549;738248;0.004685;quickSort
51500;2652250000;32767;805282;838049;739748;0.004438;quickSort
51600;2662560000;32767;806782;839549;741248;0.004833;quickSort
51700;2672890000;32767;808282;841049;742748;0.004419;quickSort
51800;2683240000;32767;809782;842549;744248;0.004726;quickSort
51900;2693610000;32767;811282;844049;745748;0.004433;quickSort
52000;2704000000;32767;812782;845549;747248;0.004399;quickSort
52100;2714410000;32767;814282;847049;748748;0.005365;quickSort
52200;2724840000;32767;815782;848549;750248;0.004442;quickSort
52300;2735290000;32767;817282;850049;751748;0.004417;quickSort
52400;2745760000;32767;818782;851549;753248;0.004580;quickSort
52500;2756250000;32767;820282;853049;754748;0.004399;quickSort
52600;2766760000;32767;821782;854549;756248;0.004362;quickSort
52700;2777290000;32767;823282;856049;757748;0.004368;quickSort
52800;2787840000;32767;824782;857549;759248;0.004673;quickSort
52900;2798410000;32767;826282;859049;760748;0.004356;quickSort
53000;2809000000;32767;827782;860549;762248;0.004890;quickSort
53100;2819610000;32767;829282;862049;763748;0.005112;quickSort
53200;2830240000;32767;830782;863549;765248;0.005313;quickSort
53300;2840890000;32767;832282;865049;766748;0.004348;quickSort
53400;2851560000;32767;833782;866549;768248;0.004333;quickSort
53500;2862250000;32767;835282;868049;769748;0.004321;quickSort
53600;2872960000;32767;836782;869549;771248;0.004334;quickSort
53700;2883690000;32767;838282;871049;772748;0.004333;quickSort
53800;2894440000;32767;839782;872549;774248;0.004303;quickSort
53900;2905210000;32767;841282;874049;775748;0.004985;quickSort
54000;2916000000;32767;842782;875549;777248;0.004313;quickSort
54100;2926810000;32767;844282;877049;778748;0.004329;quickSort
54200;2937640000;32767;845782;878549;780248;0.004293;quickSort
54300;2948490000;32767;847282;880049;781748;0.004316;quickSort
54400;2959360000;32767;848782;881549;783248;0.004287;quickSort
54500;2970250000;32767;850282;883049;784748;0.004318;quickSort
54600;2981160000;32767;851782;884549;786248;0.004618;quickSort
54700;2992090000;32767;853282;886049;787748;0.004265;quickSort
54800;3003040000;32767;854782;887549;789248;0.004299;quickSort
54900;3014010000;32767;856282;889049;790748;0.004716;quickSort
55000;3025000000;32767;857782;890549;792248;0.004257;quickSort
55100;3036010000;32767;859282;892049;793748;0.005154;quickSort
55200;3047040000;32767;860782;893549;795248;0.004611;quickSort
55300;3058090000;32767;862282;895049;796748;0.004254;quickSort
55400;3069160000;32767;863782;896549;798248;0.004248;quickSort
55500;3080250000;32767;865282;898049;799748;0.004257;quickSort
55600;3091360000;32767;866782;899549;801248;0.004247;quickSort
55700;3102490000;32767;868282;901049;802748;0.004931;quickSort
55800;3113640000;32767;869782;902549;804248;0.004249;quickSort
55900;3124810000;32767;871282;904049;805748;0.004247;quickSort
56000;3136000000;32767;872782;905549;807248;0.004875;quickSort
56100;3147210000;32767;874282;907049;808748;0.004229;quickSort
56200;3158440000;32767;875782;908549;810248;0.004634;quickSort
56300;3169690000;32767;877282;910049;811748;0.004208;quickSort
56400;3180960000;32767;878782;911549;813248;0.004669;quickSort
56500;3192250000;32767;880282;913049;814748;0.005429;quickSort
56600;3203560000;32767;881782;914549;816248;0.004189;quickSort
56700;3214890000;32767;883282;916049;817748;0.004889;quickSort
56800;3226240000;32767;884782;917549;819248;0.004172;quickSort
56900;3237610000;32767;886282;919049;820748;0.004810;quickSort
57000;3249000000;32767;887782;920549;822248;0.005624;quickSort
57100;3260410000;32767;889282;922049;823748;0.004646;quickSort
57200;3271840000;32767;890782;923549;825248;0.004815;quickSort
57300;3283290000;32767;892282;925049;826748;0.004853;quickSort
57400;3294760000;32767;893782;926549;828248;0.004777;quickSort
57500;3306250000;32767;895282;928049;829748;0.004692;quickSort
57600;3317760000;32767;896782;929549;831248;0.004590;quickSort
57700;3329290000;32767;898282;931049;832748;0.004707;quickSort
57800;3340840000;32767;899782;932549;834248;0.004223;quickSort
57900;3352410000;32767;901282;934049;835748;0.004473;quickSort
58000;3364000000;32767;902782;935549;837248;0.004143;quickSort
58100;3375610000;32767;904282;937049;838748;0.004145;quickSort
58200;3387240000;32767;905782;938549;840248;0.004134;quickSort
58300;3398890000;32767;907282;940049;841748;0.004116;quickSort
58400;3410560000;32767;908782;941549;843248;0.004130;quickSort
58500;3422250000;32767;910282;943049;844748;0.004146;quickSort
58600;3433960000;32767;911782;944549;846248;0.004017;quickSort
58700;3445690000;32767;913282;946049;847748;0.004113;quickSort
58800;3457440000;32767;914782;947549;849248;0.004461;quickSort
58900;3469210000;32767;916282;949049;850748;0.004995;quickSort
59000;3481000000;32767;917782;950549;852248;0.004143;quickSort
59100;3492810000;32767;919282;952049;853748;0.004778;quickSort
59200;3504640000;32767;920782;953549;855248;0.004615;quickSort
59300;3516490000;32767;922282;955049;856748;0.004171;quickSort
59400;3528360000;32767;923782;956549;858248;0.004159;quickSort
59500;3540250000;32767;925282;958049;859748;0.004167;quickSort
59600;3552160000;32767;926782;959549;861248;0.004175;quickSort
59700;3564090000;32767;928282;961049;862748;0.004174;quickSort
59800;3576040000;32767;929782;962549;864248;0.004189;quickSort
59900;3588010000;32767;931282;964049;865748;0.004235;quickSort
60000;3600000000;32767;932782;965549;867248;0.004835;quickSort
60100;3612010000;32767;934282;967049;868748;0.004193;quickSort
60200;3624040000;32767;935782;968549;870248;0.004618;quickSort
60300;3636090000;32767;937282;970049;871748;0.004214;quickSort
60400;3648160000;32767;938782;971549;873248;0.005511;quickSort
60500;3660250000;32767;940282;973049;874748;0.004272;quickSort
60600;3672360000;32767;941782;974549;876248;0.004226;quickSort
60700;3684490000;32767;943282;976049;877748;0.004342;quickSort
60800;3696640000;32767;944782;977549;879248;0.004238;quickSort
60900;3708810000;32767;946282;979049;880748;0.004282;quickSort
61000;3721000000;32767;947782;980549;882248;0.004247;quickSort
61100;3733210000;32767;949282;982049;883748;0.004272;quickSort
61200;3745440000;32767;950782;983549;885248;0.004282;quickSort
61300;3757690000;32767;952282;985049;886748;0.004268;quickSort
61400;3769960000;32767;953782;986549;888248;0.004264;quickSort
61500;3782250000;32767;955282;988049;889748;0.004273;quickSort
61600;3794560000;32767;956782;989549;891248;0.004298;quickSort
61700;3806890000;32767;958282;991049;892748;0.004284;quickSort
61800;3819240000;32767;959782;992549;894248;0.004300;quickSort
61900;3831610000;32767;961282;994049;895748;0.004286;quickSort
62000;3844000000;32767;962782;995549;897248;0.004304;quickSort
62100;3856410000;32767;964282;997049;898748;0.004310;quickSort
62200;3868840000;32767;965782;998549;900248;0.004340;quickSort
62300;3881290000;32767;967282;1000049;901748;0.004325;quickSort
62400;3893760000;32767;968782;1001549;903248;0.004886;quickSort
62500;3906250000;32767;970282;1003049;904748;0.004332;quickSort
62600;3918760000;32767;971782;1004549;906248;0.005536;quickSort
62700;3931290000;32767;973282;1006049;907748;0.004365;quickSort
62800;3943840000;32767;974782;1007549;909248;0.004359;quickSort
62900;3956410000;32767;976282;1009049;910748;0.004353;quickSort
63000;3969000000;32767;977782;1010549;912248;0.004417;quickSort
63100;3981610000;32767;979282;1012049;913748;0.004376;quickSort
63200;3994240000;32767;980782;1013549;915248;0.004374;quickSort
63300;4006890000;32767;982282;1015049;916748;0.005198;quickSort
63400;4019560000;32767;983782;1016549;918248;0.004398;quickSort
63500;4032250000;32767;985282;1018049;919748;0.004403;quickSort
63600;4044960000;32767;986782;1019549;921248;0.004415;quickSort
63700;4057690000;32767;988282;1021049;922748;0.004425;quickSort
63800;4070440000;32767;989782;1022549;924248;0.004420;quickSort
63900;4083210000;32767;991282;1024049;925748;0.005342;quickSort
64000;4096000000;32767;992782;1025549;927248;0.004424;quickSort
64100;4108810000;32767;994282;1027049;928748;0.004494;quickSort
64200;4121640000;32767;995782;1028549;930248;0.004449;quickSort
64300;4134490000;32767;997282;1030049;931748;0.004461;quickSort
64400;4147360000;32767;998782;1031549;933248;0.004598;quickSort
64500;4160250000;32767;1000282;1033049;934748;0.004441;quickSort
64600;4173160000;32767;1001782;1034549;936248;0.004455;quickSort
64700;4186090000;32767;1003282;1036049;937748;0.004469;quickSort
64800;4199040000;32767;1004782;1037549;939248;0.004466;quickSort
64900;4212010000;32767;1006282;1039049;940748;0.004473;quickSort
65000;4225000000;32767;1007782;1040549;942248;0.004825;quickSort
65100;4238010000;32767;1009282;1042049;943748;0.004478;quickSort
65200;4251040000;32767;1010782;1043549;945248;0.004480;quickSort
65300;4264090000;32767;1012282;1045049;946748;0.004486;quickSort
65400;4277160000;32767;1013782;1046549;948248;0.004482;quickSort
65500;4290250000;32767;1015282;1048049;949748;0.005093;quickSort
65600;4303360000;32832;1017042;1049874;951378;0.004502;quickSort
65700;4316490000;32932;1018942;1051874;953078;0.004496;quickSort
65800;4329640000;33032;1020842;1053874;954778;0.004525;quickSort
65900;4342810000;33132;1022742;1055874;956478;0.004520;quickSort
66000;4356000000;33232;1024642;1057874;958178;0.004566;quickSort
66100;4369210000;33332;1026542;1059874;959878;0.004577;quickSort
66200;4382440000;33432;1028442;1061874;961578;0.004572;quickSort
66300;4395690000;33532;1030342;1063874;963278;0.004575;quickSort
66400;4408960000;33632;1032242;1065874;964978;0.004592;quickSort
66500;4422250000;33732;1034142;1067874;966678;0.004605;quickSort
66600;4435560000;33832;1036042;1069874;968378;0.004617;quickSort
66700;4448890000;33932;1037942;1071874;970078;0.004635;quickSort
66800;4462240000;34032;1039842;1073874;971778;0.004639;quickSort
66900;4475610000;34132;1041742;1075874;973478;0.004646;quickSort
67000;4489000000;34232;1043642;1077874;975178;0.004669;quickSort
67100;4502410000;34332;1045542;1079874;976878;0.004690;quickSort
67200;4515840000;34432;1047442;1081874;978578;0.004683;quickSort
67300;4529290000;34532;1049342;1083874;980278;0.004698;quickSort
67400;4542760000;34632;1051242;1085874;981978;0.005473;quickSort
67500;4556250000;34732;1053142;1087874;983678;0.004739;quickSort
67600;4569760000;34832;1055042;1089874;985378;0.004818;quickSort
67700;4583290000;34932;1056942;1091874;987078;0.004838;quickSort
67800;4596840000;35032;1058842;1093874;988778;0.004748;quickSort
67900;4610410000;35132;1060742;1095874;990478;0.004772;quickSort
68000;4624000000;35232;1062642;1097874;992178;0.004796;quickSort
68100;4637610000;35332;1064542;1099874;993878;0.004776;quickSort
68200;4651240000;35432;1066442;1101874;995578;0.004786;quickSort
68300;4664890000;35532;1068342;1103874;997278;0.004805;quickSort
68400;4678560000;35632;1070242;1105874;998978;0.004803;quickSort
68500;4692250000;35732;1072142;1107874;1000678;0.004818;quickSort
68600;4705960000;35832;1074042;1109874;1002378;0.004823;quickSort
68700;4719690000;35932;1075942;1111874;1004078;0.004844;quickSort
68800;4733440000;36032;1077842;1113874;1005778;0.004842;quickSort
68900;4747210000;36132;1079742;1115874;1007478;0.004849;quickSort
69000;4761000000;36232;1081642;1117874;1009178;0.004868;quickSort
69100;4774810000;36332;1083542;1119874;1010878;0.005062;quickSort
69200;4788640000;36432;1085442;1121874;1012578;0.004884;quickSort
69300;4802490000;36532;1087342;1123874;1014278;0.005608;quickSort
69400;4816360000;36632;1089242;1125874;1015978;0.004888;quickSort
69500;4830250000;36732;1091142;1127874;1017678;0.004919;quickSort
69600;4844160000;36832;1093042;1129874;1019378;0.004913;quickSort
69700;4858090000;36932;1094942;1131874;1021078;0.004910;quickSort
69800;4872040000;37032;1096842;1133874;1022778;0.005822;quickSort
69900;4886010000;37132;1098742;1135874;1024478;0.004961;quickSort
70000;4900000000;37232;1100642;1137874;1026178;0.004939;quickSort
70100;4914010000;37332;1102542;1139874;1027878;0.004949;quickSort
70200;4928040000;37432;1104442;1141874;1029578;0.004981;quickSort
70300;4942090000;37532;1106342;1143874;1031278;0.005058;quickSort
70400;4956160000;37632;1108242;1145874;1032978;0.005271;quickSort
70500;4970250000;37732;1110142;1147874;1034678;0.005276;quickSort
70600;4984360000;37832;1112042;1149874;1036378;0.005229;quickSort
70700;4998490000;37932;1113942;1151874;1038078;0.005071;quickSort
70800;5012640000;38032;1115842;1153874;1039778;0.005055;quickSort
70900;5026810000;38132;1117742;1155874;1041478;0.005251;quickSort
71000;5041000000;38232;1119642;1157874;1043178;0.005757;quickSort
71100;5055210000;38332;1121542;1159874;1044878;0.005067;quickSort
71200;5069440000;38432;1123442;1161874;1046578;0.006399;quickSort
71300;5083690000;38532;1125342;1163874;1048278;0.005779;quickSort
71400;5097960000;38632;1127242;1165874;1049978;0.005619;quickSort
71500;5112250000;38732;1129142;1167874;1051678;0.005007;quickSort
71600;5126560000;38832;1131042;1169874;1053378;0.005098;quickSort
71700;5140890000;38932;1132942;1171874;1055078;0.005128;quickSort
71800;5155240000;39032;1134842;1173874;1056778;0.005105;quickSort
71900;5169610000;39132;1136742;1175874;1058478;0.005132;quickSort
72000;5184000000;39232;1138642;1177874;1060178;0.005160;quickSort
72100;5198410000;39332;1140542;1179874;1061878;0.005137;quickSort
72200;5212840000;39432;1142442;1181874;1063578;0.005141;quickSort
72300;5227290000;39532;1144342;1183874;1065278;0.005260;quickSort
72400;5241760000;39632;1146242;1185874;1066978;0.005066;quickSort
72500;5256250000;39732;1148142;1187874;1068678;0.005348;quickSort
72600;5270760000;39832;1150042;1189874;1070378;0.005038;quickSort
72700;5285290000;39932;1151942;1191874;1072078;0.007045;quickSort
72800;5299840000;40032;1153842;1193874;1073778;0.005180;quickSort
72900;5314410000;40132;1155742;1195874;1075478;0.005192;quickSort
73000;5329000000;40232;1157642;1197874;1077178;0.005289;quickSort
73100;5343610000;40332;1159542;1199874;1078878;0.005210;quickSort
73200;5358240000;40432;1161442;1201874;1080578;0.005239;quickSort
73300;5372890000;40532;1163342;1203874;1082278;0.005208;quickSort
73400;5387560000;40632;1165242;1205874;1083978;0.005278;quickSort
73500;5402250000;40732;1167142;1207874;1085678;0.005539;quickSort
73600;5416960000;40832;1169042;1209874;1087378;0.005329;quickSort
73700;5431690000;40932;1170942;1211874;1089078;0.005277;quickSort
73800;5446440000;41032;1172842;1213874;1090778;0.005460;quickSort
73900;5461210000;41132;1174742;1215874;1092478;0.005293;quickSort
74000;5476000000;41232;1176642;1217874;1094178;0.005300;quickSort
74100;5490810000;41332;1178542;1219874;1095878;0.005283;quickSort
74200;5505640000;41432;1180442;1221874;1097578;0.005293;quickSort
74300;5520490000;41532;1182342;1223874;1099278;0.005429;quickSort
74400;5535360000;41632;1184242;1225874;1100978;0.005319;quickSort
74500;5550250000;41732;1186142;1227874;1102678;0.005313;quickSort
74600;5565160000;41832;1188042;1229874;1104378;0.005335;quickSort
74700;5580090000;41932;1189942;1231874;1106078;0.005447;quickSort
74800;5595040000;42032;1191842;1233874;1107778;0.005369;quickSort
74900;5610010000;42132;1193742;1235874;1109478;0.005355;quickSort
75000;5625000000;42232;1195642;1237874;1111178;0.005390;quickSort
75100;5640010000;42332;1197542;1239874;1112878;0.005396;quickSort
75200;5655040000;42432;1199442;1241874;1114578;0.005414;quickSort
75300;5670090000;42532;1201342;1243874;1116278;0.005410;quickSort
75400;5685160000;42632;1203242;1245874;1117978;0.005402;quickSort
75500;5700250000;42732;1205142;1247874;1119678;0.006031;quickSort
75600;5715360000;42832;1207042;1249874;1121378;0.005501;quickSort
75700;5730490000;42932;1208942;1251874;1123078;0.005455;quickSort
75800;5745640000;43032;1210842;1253874;1124778;0.006603;quickSort
75900;5760810000;43132;1212742;1255874;1126478;0.005459;quickSort
76000;5776000000;43232;1214642;1257874;1128178;0.005512;quickSort
76100;5791210000;43332;1216542;1259874;1129878;0.005959;quickSort
76200;5806440000;43432;1218442;1261874;1131578;0.005515;quickSort
76300;5821690000;43532;1220342;1263874;1133278;0.005543;quickSort
76400;5836960000;43632;1222242;1265874;1134978;0.005505;quickSort
76500;5852250000;43732;1224142;1267874;1136678;0.005548;quickSort
76600;5867560000;43832;1226042;1269874;1138378;0.005558;quickSort
76700;5882890000;43932;1227942;1271874;1140078;0.005544;quickSort
76800;5898240000;44032;1229842;1273874;1141778;0.005609;quickSort
76900;5913610000;44132;1231742;1275874;1143478;0.005553;quickSort
77000;5929000000;44232;1233642;1277874;1145178;0.005571;quickSort
77100;5944410000;44332;1235542;1279874;1146878;0.005580;quickSort
77200;5959840000;44432;1237442;1281874;1148578;0.005605;quickSort
77300;5975290000;44532;1239342;1283874;1150278;0.005598;quickSort
77400;5990760000;44632;1241242;1285874;1151978;0.006589;quickSort
77500;6006250000;44732;1243142;1287874;1153678;0.005798;quickSort
77600;6021760000;44832;1245042;1289874;1155378;0.005613;quickSort
77700;6037290000;44932;1246942;1291874;1157078;0.005617;quickSort
77800;6052840000;45032;1248842;1293874;1158778;0.005631;quickSort
77900;6068410000;45132;1250742;1295874;1160478;0.006177;quickSort
78000;6084000000;45232;1252642;1297874;1162178;0.005650;quickSort
78100;6099610000;45332;1254542;1299874;1163878;0.005710;quickSort
78200;6115240000;45432;1256442;1301874;1165578;0.005663;quickSort
78300;6130890000;45532;1258342;1303874;1167278;0.006993;quickSort
78400;6146560000;45632;1260242;1305874;1168978;0.005697;quickSort
78500;6162250000;45732;1262142;1307874;1170678;0.005705;quickSort
78600;6177960000;45832;1264042;1309874;1172378;0.006008;quickSort
78700;6193690000;45932;1265942;1311874;1174078;0.005857;quickSort
78800;6209440000;46032;1267842;1313874;1175778;0.006165;quickSort
78900;6225210000;46132;1269742;1315874;1177478;0.005766;quickSort
79000;6241000000;46232;1271642;1317874;1179178;0.005814;quickSort
79100;6256810000;46332;1273542;1319874;1180878;0.005954;quickSort
79200;6272640000;46432;1275442;1321874;1182578;0.006220;quickSort
79300;6288490000;46532;1277342;1323874;1184278;0.006031;quickSort
79400;6304360000;46632;1279242;1325874;1185978;0.005866;quickSort
79500;6320250000;46732;1281142;1327874;1187678;0.005814;quickSort
79600;6336160000;46832;1283042;1329874;1189378;0.005808;quickSort
79700;6352090000;46932;1284942;1331874;1191078;0.005838;quickSort
79800;6368040000;47032;1286842;1333874;1192778;0.005829;quickSort
79900;6384010000;47132;1288742;1335874;1194478;0.005856;quickSort
80000;6400000000;47232;1290642;1337874;1196178;0.005851;quickSort
80100;6416010000;47332;1292542;1339874;1197878;0.006033;quickSort
80200;6432040000;47432;1294442;1341874;1199578;0.005852;quickSort
80300;6448090000;47532;1296342;1343874;1201278;0.005876;quickSort
80400;6464160000;47632;1298242;1345874;1202978;0.005886;quickSort
80500;6480250000;47732;1300142;1347874;1204678;0.005890;quickSort
80600;6496360000;47832;1302042;1349874;1206378;0.005946;quickSort
80700;6512490000;47932;1303942;1351874;1208078;0.005901;quickSort
80800;6528640000;48032;1305842;1353874;1209778;0.005995;quickSort
80900;6544810000;48132;1307742;1355874;1211478;0.005926;quickSort
81000;6561000000;48232;1309642;1357874;1213178;0.005945;quickSort
81100;6577210000;48332;1311542;1359874;1214878;0.006979;quickSort
81200;6593440000;48432;1313442;1361874;1216578;0.005961;quickSort
81300;6609690000;48532;1315342;1363874;1218278;0.005955;quickSort
81400;6625960000;48632;1317242;1365874;1219978;0.006054;quickSort
81500;6642250000;48732;1319142;1367874;1221678;0.006028;quickSort
81600;6658560000;48832;1321042;1369874;1223378;0.005986;quickSort
81700;6674890000;48932;1322942;1371874;1225078;0.006020;quickSort
81800;6691240000;49032;1324842;1373874;1226778;0.006013;quickSort
81900;6707610000;49132;1326742;1375874;1228478;0.005993;quickSort
82000;6724000000;49232;1328642;1377874;1230178;0.006051;quickSort
82100;6740410000;49332;1330542;1379874;1231878;0.006090;quickSort
82200;6756840000;49432;1332442;1381874;1233578;0.006660;quickSort
82300;6773290000;49532;1334342;1383874;1235278;0.006054;quickSort
82400;6789760000;49632;1336242;1385874;1236978;0.006152;quickSort
82500;6806250000;49732;1338142;1387874;1238678;0.006075;quickSort
82600;6822760000;49832;1340042;1389874;1240378;0.006098;quickSort
82700;6839290000;49932;1341942;1391874;1242078;0.006096;quickSort
82800;6855840000;50032;1343842;1393874;1243778;0.006122;quickSort
82900;6872410000;50132;1345742;1395874;1245478;0.006115;quickSort
83000;6889000000;50232;1347642;1397874;1247178;0.006177;quickSort
83100;6905610000;50332;1349542;1399874;1248878;0.006138;quickSort
83200;6922240000;50432;1351442;1401874;1250578;0.006141;quickSort
83300;6938890000;50532;1353342;1403874;1252278;0.006876;quickSort
83400;6955560000;50632;1355242;1405874;1253978;0.006193;quickSort
83500;6972250000;50732;1357142;1407874;1255678;0.006373;quickSort
83600;6988960000;50832;1359042;1409874;1257378;0.006211;quickSort
83700;7005690000;50932;1360942;1411874;1259078;0.006246;quickSort
83800;7022440000;51032;1362842;1413874;1260778;0.006230;quickSort
83900;7039210000;51132;1364742;1415874;1262478;0.006267;quickSort
84000;7056000000;51232;1366642;1417874;1264178;0.006416;quickSort
84100;7072810000;51332;1368542;1419874;1265878;0.006269;quickSort
84200;7089640000;51432;1370442;1421874;1267578;0.006261;quickSort
84300;7106490000;51532;1372342;1423874;1269278;0.006279;quickSort
84400;7123360000;51632;1374242;1425874;1270978;0.006442;quickSort
84500;7140250000;51732;1376142;1427874;1272678;0.007145;quickSort
84600;7157160000;51832;1378042;1429874;1274378;0.006308;quickSort
84700;7174090000;51932;1379942;1431874;1276078;0.006339;quickSort
84800;7191040000;52032;1381842;1433874;1277778;0.006472;quickSort
84900;7208010000;52132;1383742;1435874;1279478;0.006453;quickSort
85000;7225000000;52232;1385642;1437874;1281178;0.006461;quickSort
85100;7242010000;52332;1387542;1439874;1282878;0.006382;quickSort
85200;7259040000;52432;1389442;1441874;1284578;0.006421;quickSort
85300;7276090000;52532;1391342;1443874;1286278;0.006355;quickSort
85400;7293160000;52632;1393242;1445874;1287978;0.006379;quickSort
85500;7310250000;52732;1395142;1447874;1289678;0.006417;quickSort
85600;7327360000;52832;1397042;1449874;1291378;0.006426;quickSort
85700;7344490000;52932;1398942;1451874;1293078;0.006471;quickSort
85800;7361640000;53032;1400842;1453874;1294778;0.006659;quickSort
85900;7378810000;53132;1402742;1455874;1296478;0.006609;quickSort
86000;7396000000;53232;1404642;1457874;1298178;0.006454;quickSort
86100;7413210000;53332;1406542;1459874;1299878;0.006472;quickSort
86200;7430440000;53432;1408442;1461874;1301578;0.006494;quickSort
86300;7447690000;53532;1410342;1463874;1303278;0.006478;quickSort
86400;7464960000;53632;1412242;1465874;1304978;0.006478;quickSort
86500;7482250000;53732;1414142;1467874;1306678;0.006691;quickSort
86600;7499560000;53832;1416042;1469874;1308378;0.006500;quickSort
86700;7516890000;53932;1417942;1471874;1310078;0.008380;quickSort
86800;7534240000;54032;1419842;1473874;1311778;0.006585;quickSort
86900;7551610000;54132;1421742;1475874;1313478;0.006696;quickSort
87000;7569000000;54232;1423642;1477874;1315178;0.006558;quickSort
87100;7586410000;54332;1425542;1479874;1316878;0.006543;quickSort
87200;7603840000;54432;1427442;1481874;1318578;0.006568;quickSort
87300;7621290000;54532;1429342;1483874;1320278;0.006580;quickSort
87400;7638760000;54632;1431242;1485874;1321978;0.006581;quickSort
87500;7656250000;54732;1433142;1487874;1323678;0.006640;quickSort
87600;7673760000;54832;1435042;1489874;1325378;0.006616;quickSort
87700;7691290000;54932;1436942;1491874;1327078;0.007124;quickSort
87800;7708840000;55032;1438842;1493874;1328778;0.006637;quickSort
87900;7726410000;55132;1440742;1495874;1330478;0.006694;quickSort
88000;7744000000;55232;1442642;1497874;1332178;0.006625;quickSort
88100;7761610000;55332;1444542;1499874;1333878;0.006636;quickSort
88200;7779240000;55432;1446442;1501874;1335578;0.006668;quickSort
88300;7796890000;55532;1448342;1503874;1337278;0.006759;quickSort
88400;7814560000;55632;1450242;1505874;1338978;0.006669;quickSort
88500;7832250000;55732;1452142;1507874;1340678;0.006672;quickSort
88600;7849960000;55832;1454042;1509874;1342378;0.006696;quickSort
88700;7867690000;55932;1455942;1511874;1344078;0.006708;quickSort
88800;7885440000;56032;1457842;1513874;1345778;0.006672;quickSort
88900;7903210000;56132;1459742;1515874;1347478;0.006698;quickSort
89000;7921000000;56232;1461642;1517874;1349178;0.006730;quickSort
89100;7938810000;56332;1463542;1519874;1350878;0.006789;quickSort
89200;7956640000;56432;1465442;1521874;1352578;0.006718;quickSort
89300;7974490000;56532;1467342;1523874;1354278;0.006713;quickSort
89400;7992360000;56632;1469242;1525874;1355978;0.006740;quickSort
89500;8010250000;56732;1471142;1527874;1357678;0.006718;quickSort
89600;8028160000;56832;1473042;1529874;1359378;0.006744;quickSort
89700;8046090000;56932;1474942;1531874;1361078;0.006860;quickSort
89800;8064040000;57032;1476842;1533874;1362778;0.006761;quickSort
89900;8082010000;57132;1478742;1535874;1364478;0.006780;quickSort
90000;8100000000;57232;1480642;1537874;1366178;0.006767;quickSort
90100;8118010000;57332;1482542;1539874;1367878;0.006777;quickSort
90200;8136040000;57432;1484442;1541874;1369578;0.006814;quickSort
90300;8154090000;57532;1486342;1543874;1371278;0.006841;quickSort
90400;8172160000;57632;1488242;1545874;1372978;0.006824;quickSort
90500;8190250000;57732;1490142;1547874;1374678;0.006843;quickSort
90600;8208360000;57832;1492042;1549874;1376378;0.006827;quickSort
90700;8226490000;57932;1493942;1551874;1378078;0.006834;quickSort
90800;8244640000;58032;1495842;1553874;1379778;0.006843;quickSort
90900;8262810000;58132;1497742;1555874;1381478;0.006867;quickSort
91000;8281000000;58232;1499642;1557874;1383178;0.006863;quickSort
91100;8299210000;58332;1501542;1559874;1384878;0.006883;quickSort
91200;8317440000;58432;1503442;1561874;1386578;0.006892;quickSort
91300;8335690000;58532;1505342;1563874;1388278;0.006897;quickSort
91400;8353960000;58632;1507242;1565874;1389978;0.006906;quickSort
91500;8372250000;58732;1509142;1567874;1391678;0.007008;quickSort
91600;8390560000;58832;1511042;1569874;1393378;0.006928;quickSort
91700;8408890000;58932;1512942;1571874;1395078;0.007043;quickSort
91800;8427240000;59032;1514842;1573874;1396778;0.007712;quickSort
91900;8445610000;59132;1516742;1575874;1398478;0.006951;quickSort
92000;8464000000;59232;1518642;1577874;1400178;0.006941;quickSort
92100;8482410000;59332;1520542;1579874;1401878;0.006988;quickSort
92200;8500840000;59432;1522442;1581874;1403578;0.006981;quickSort
92300;8519290000;59532;1524342;1583874;1405278;0.007012;quickSort
92400;8537760000;59632;1526242;1585874;1406978;0.007002;quickSort
92500;8556250000;59732;1528142;1587874;1408678;0.007010;quickSort
92600;8574760000;59832;1530042;1589874;1410378;0.007014;quickSort
92700;8593290000;59932;1531942;1591874;1412078;0.007029;quickSort
92800;8611840000;60032;1533842;1593874;1413778;0.007062;quickSort
92900;8630410000;60132;1535742;1595874;1415478;0.007048;quickSort
93000;8649000000;60232;1537642;1597874;1417178;0.007141;quickSort
93100;8667610000;60332;1539542;1599874;1418878;0.007335;quickSort
93200;8686240000;60432;1541442;1601874;1420578;0.007073;quickSort
93300;8704890000;60532;1543342;1603874;1422278;0.007075;quickSort
93400;8723560000;60632;1545242;1605874;1423978;0.007091;quickSort
93500;8742250000;60732;1547142;1607874;1425678;0.007725;quickSort
93600;8760960000;60832;1549042;1609874;1427378;0.007113;quickSort
93700;8779690000;60932;1550942;1611874;1429078;0.007108;quickSort
93800;8798440000;61032;1552842;1613874;1430778;0.007111;quickSort
93900;8817210000;61132;1554742;1615874;1432478;0.007145;quickSort
94000;8836000000;61232;1556642;1617874;1434178;0.007730;quickSort
94100;8854810000;61332;1558542;1619874;1435878;0.007133;quickSort
94200;8873640000;61432;1560442;1621874;1437578;0.007156;quickSort
94300;8892490000;61532;1562342;1623874;1439278;0.007177;quickSort
94400;8911360000;61632;1564242;1625874;1440978;0.007197;quickSort
94500;8930250000;61732;1566142;1627874;1442678;0.007174;quickSort
94600;8949160000;61832;1568042;1629874;1444378;0.007205;quickSort
94700;8968090000;61932;1569942;1631874;1446078;0.007806;quickSort
94800;8987040000;62032;1571842;1633874;1447778;0.007226;quickSort
94900;9006010000;62132;1573742;1635874;1449478;0.007221;quickSort
95000;9025000000;62232;1575642;1637874;1451178;0.007322;quickSort
95100;9044010000;62332;1577542;1639874;1452878;0.007277;quickSort
95200;9063040000;62432;1579442;1641874;1454578;0.007341;quickSort
95300;9082090000;62532;1581342;1643874;1456278;0.007543;quickSort
95400;9101160000;62632;1583242;1645874;1457978;0.007430;quickSort
95500;9120250000;62732;1585142;1647874;1459678;0.007300;quickSort
95600;9139360000;62832;1587042;1649874;1461378;0.007301;quickSort
95700;9158490000;62932;1588942;1651874;1463078;0.007319;quickSort
95800;9177640000;63032;1590842;1653874;1464778;0.007308;quickSort
95900;9196810000;63132;1592742;1655874;1466478;0.007361;quickSort
96000;9216000000;63232;1594642;1657874;1468178;0.007370;quickSort
96100;9235210000;63332;1596542;1659874;1469878;0.007464;quickSort
96200;9254440000;63432;1598442;1661874;1471578;0.007341;quickSort
96300;9273690000;63532;1600342;1663874;1473278;0.007368;quickSort
96400;9292960000;63632;1602242;1665874;1474978;0.007414;quickSort
96500;9312250000;63732;1604142;1667874;1476678;0.007376;quickSort
96600;9331560000;63832;1606042;1669874;1478378;0.007385;quickSort
96700;9350890000;63932;1607942;1671874;1480078;0.007385;quickSort
96800;9370240000;64032;1609842;1673874;1481778;0.007422;quickSort
96900;9389610000;64132;1611742;1675874;1483478;0.007422;quickSort
97000;9409000000;64232;1613642;1677874;1485178;0.007443;quickSort
97100;9428410000;64332;1615542;1679874;1486878;0.007456;quickSort
97200;9447840000;64432;1617442;1681874;1488578;0.007448;quickSort
97300;9467290000;64532;1619342;1683874;1490278;0.007434;quickSort
97400;9486760000;64632;1621242;1685874;1491978;0.007449;quickSort
97500;9506250000;64732;1623142;1687874;1493678;0.007502;quickSort
97600;9525760000;64832;1625042;1689874;1495378;0.007475;quickSort
97700;9545290000;64932;1626942;1691874;1497078;0.007562;quickSort
97800;9564840000;65032;1628842;1693874;1498778;0.007811;quickSort
97900;9584410000;65132;1630742;1695874;1500478;0.007709;quickSort
98000;9604000000;65232;1632642;1697874;1502178;0.007765;quickSort
98100;9623610000;65332;1634542;1699874;1503878;0.007543;quickSort
98200;9643240000;65432;1636442;1701874;1505578;0.007574;quickSort
98300;9662890000;65532;1638342;1703874;1507278;0.007541;quickSort
98400;9682560000;65535;1639951;1705486;1508881;0.007739;quickSort
98500;9702250000;65535;1641551;1707086;1510481;0.007619;quickSort
98600;9721960000;65535;1643151;1708686;1512081;0.007729;quickSort
98700;9741690000;65535;1644751;1710286;1513681;0.007564;quickSort
98800;9761440000;65535;1646351;1711886;1515281;0.008399;quickSort
98900;9781210000;65535;1647951;1713486;1516881;0.008268;quickSort
99000;9801000000;65535;1649551;1715086;1518481;0.007776;quickSort
99100;9820810000;65535;1651151;1716686;1520081;0.007755;quickSort
99200;9840640000;65535;1652751;1718286;1521681;0.007616;quickSort
99300;9860490000;65535;1654351;1719886;1523281;0.007629;quickSort
99400;9880360000;65535;1655951;1721486;1524881;0.007628;quickSort
99500;9900250000;65535;1657551;1723086;1526481;0.008259;quickSort
99600;9920160000;65535;1659151;1724686;1528081;0.007654;quickSort
99700;9940090000;65535;1660751;1726286;1529681;0.008355;quickSort
99800;9960040000;65535;1662351;1727886;1531281;0.007891;quickSort
99900;9980010000;65535;1663951;1729486;1532881;0.007897;quickSort
100000;10000000000;65535;1665551;1731086;1534481;0.007766;quickSort
100100;10020010000;65535;1667151;1732686;1536081;0.007730;quickSort
100200;10040040000;65535;1668751;1734286;1537681;0.007724;quickSort
100300;10060090000;65535;1670351;1735886;1539281;0.007696;quickSort
100400;10080160000;65535;1671951;1737486;1540881;0.007723;quickSort
100500;10100250000;65535;1673551;1739086;1542481;0.007735;quickSort
100600;10120360000;65535;1675151;1740686;1544081;0.007749;quickSort
100700;10140490000;65535;1676751;1742286;1545681;0.007739;quickSort
100800;10160640000;65535;1678351;1743886;1547281;0.007769;quickSort
100900;10180810000;65535;1679951;1745486;1548881;0.007752;quickSort
101000;10201000000;65535;1681551;1747086;1550481;0.007770;quickSort
101100;10221210000;65535;1683151;1748686;1552081;0.007825;quickSort
101200;10241440000;65535;1684751;1750286;1553681;0.007778;quickSort
101300;10261690000;65535;1686351;1751886;1555281;0.007783;quickSort
101400;10281960000;65535;1687951;1753486;1556881;0.007801;quickSort
101500;10302250000;65535;1689551;1755086;1558481;0.007984;quickSort
101600;10322560000;65535;1691151;1756686;1560081;0.007797;quickSort
101700;10342890000;65535;1692751;1758286;1561681;0.007818;quickSort
101800;10363240000;65535;1694351;1759886;1563281;0.007808;quickSort
101900;10383610000;65535;1695951;1761486;1564881;0.007841;quickSort
102000;10404000000;65535;1697551;1763086;1566481;0.007849;quickSort
102100;10424410000;65535;1699151;1764686;1568081;0.007846;quickSort
102200;10444840000;65535;1700751;1766286;1569681;0.007925;quickSort
102300;10465290000;65535;1702351;1767886;1571281;0.007867;quickSort
102400;10485760000;65535;1703951;1769486;1572881;0.007890;quickSort
102500;10506250000;65535;1705551;1771086;1574481;0.007903;quickSort
102600;10526760000;65535;1707151;1772686;1576081;0.007999;quickSort
102700;10547290000;65535;1708751;1774286;1577681;0.007706;quickSort
102800;10567840000;65535;1710351;1775886;1579281;0.007724;quickSort
102900;10588410000;65535;1711951;1777486;1580881;0.007880;quickSort
103000;10609000000;65535;1713551;1779086;1582481;0.007894;quickSort
103100;10629610000;65535;1715151;1780686;1584081;0.007915;quickSort
103200;10650240000;65535;1716751;1782286;1585681;0.007918;quickSort
103300;10670890000;65535;1718351;1783886;1587281;0.007926;quickSort
103400;10691560000;65535;1719951;1785486;1588881;0.007905;quickSort
103500;10712250000;65535;1721551;1787086;1590481;0.007969;quickSort
103600;10732960000;65535;1723151;1788686;1592081;0.008562;quickSort
103700;10753690000;65535;1724751;1790286;1593681;0.007955;quickSort
103800;10774440000;65535;1726351;1791886;1595281;0.008004;quickSort
103900;10795210000;65535;1727951;1793486;1596881;0.007971;quickSort
104000;10816000000;65535;1729551;1795086;1598481;0.007956;quickSort
104100;10836810000;65535;1731151;1796686;1600081;0.007999;quickSort
104200;10857640000;65535;1732751;1798286;1601681;0.007997;quickSort
104300;10878490000;65535;1734351;1799886;1603281;0.008017;quickSort
104400;10899360000;65535;1735951;1801486;1604881;0.008078;quickSort
104500;10920250000;65535;1737551;1803086;1606481;0.008083;quickSort
104600;10941160000;65535;1739151;1804686;1608081;0.008026;quickSort
104700;10962090000;65535;1740751;1806286;1609681;0.008037;quickSort
104800;10983040000;65535;1742351;1807886;1611281;0.008054;quickSort
104900;11004010000;65535;1743951;1809486;1612881;0.008029;quickSort
105000;11025000000;65535;1745551;1811086;1614481;0.008044;quickSort
105100;11046010000;65535;1747151;1812686;1616081;0.008063;quickSort
105200;11067040000;65535;1748751;1814286;1617681;0.008055;quickSort
105300;11088090000;65535;1750351;1815886;1619281;0.008078;quickSort
105400;11109160000;65535;1751951;1817486;1620881;0.008050;quickSort
105500;11130250000;65535;1753551;1819086;1622481;0.008071;quickSort
105600;11151360000;65535;1755151;1820686;1624081;0.008070;quickSort
105700;11172490000;65535;1756751;1822286;1625681;0.008071;quickSort
105800;11193640000;65535;1758351;1823886;1627281;0.008110;quickSort
105900;11214810000;65535;1759951;1825486;1628881;0.008073;quickSort
106000;11236000000;65535;1761551;1827086;1630481;0.008110;quickSort
106100;11257210000;65535;1763151;1828686;1632081;0.008086;quickSort
106200;11278440000;65535;1764751;1830286;1633681;0.008111;quickSort
106300;11299690000;65535;1766351;1831886;1635281;0.008117;quickSort
106400;11320960000;65535;1767951;1833486;1636881;0.008133;quickSort
106500;11342250000;65535;1769551;1835086;1638481;0.008177;quickSort
106600;11363560000;65535;1771151;1836686;1640081;0.008237;quickSort
106700;11384890000;65535;1772751;1838286;1641681;0.008188;quickSort
106800;11406240000;65535;1774351;1839886;1643281;0.008142;quickSort
106900;11427610000;65535;1775951;1841486;1644881;0.008146;quickSort
107000;11449000000;65535;1777551;1843086;1646481;0.008144;quickSort
107100;11470410000;65535;1779151;1844686;1648081;0.008173;quickSort
107200;11491840000;65535;1780751;1846286;1649681;0.008171;quickSort
107300;11513290000;65535;1782351;1847886;1651281;0.008155;quickSort
107400;11534760000;65535;1783951;1849486;1652881;0.008337;quickSort
107500;11556250000;65535;1785551;1851086;1654481;0.008179;quickSort
107600;11577760000;65535;1787151;1852686;1656081;0.008173;quickSort
107700;11599290000;65535;1788751;1854286;1657681;0.008498;quickSort
107800;11620840000;65535;1790351;1855886;1659281;0.008193;quickSort
107900;11642410000;65535;1791951;1857486;1660881;0.008183;quickSort
108000;11664000000;65535;1793551;1859086;1662481;0.008224;quickSort
108100;11685610000;65535;1795151;1860686;1664081;0.008213;quickSort
108200;11707240000;65535;1796751;1862286;1665681;0.008231;quickSort
108300;11728890000;65535;1798351;1863886;1667281;0.008208;quickSort
108400;11750560000;65535;1799951;1865486;1668881;0.009320;quickSort
108500;11772250000;65535;1801551;1867086;1670481;0.008785;quickSort
108600;11793960000;65535;1803151;1868686;1672081;0.008243;quickSort
108700;11815690000;65535;1804751;1870286;1673681;0.008282;quickSort
108800;11837440000;65535;1806351;1871886;1675281;0.008313;quickSort
108900;11859210000;65535;1807951;1873486;1676881;0.008308;quickSort
109000;11881000000;65535;1809551;1875086;1678481;0.010079;quickSort
109100;11902810000;65535;1811151;1876686;1680081;0.008274;quickSort
109200;11924640000;65535;1812751;1878286;1681681;0.008294;quickSort
109300;11946490000;65535;1814351;1879886;1683281;0.008292;quickSort
109400;11968360000;65535;1815951;1881486;1684881;0.008457;quickSort
109500;11990250000;65535;1817551;1883086;1686481;0.008299;quickSort
109600;12012160000;65535;1819151;1884686;1688081;0.008317;quickSort
109700;12034090000;65535;1820751;1886286;1689681;0.008344;quickSort
109800;12056040000;65535;1822351;1887886;1691281;0.008901;quickSort
109900;12078010000;65535;1823951;1889486;1692881;0.008341;quickSort
110000;12100000000;65535;1825551;1891086;1694481;0.008369;quickSort
110100;12122010000;65535;1827151;1892686;1696081;0.008345;quickSort
110200;12144040000;65535;1828751;1894286;1697681;0.008332;quickSort
110300;12166090000;65535;1830351;1895886;1699281;0.008469;quickSort
110400;12188160000;65535;1831951;1897486;1700881;0.008341;quickSort
110500;12210250000;65535;1833551;1899086;1702481;0.008352;quickSort
110600;12232360000;65535;1835151;1900686;1704081;0.009002;quickSort
110700;12254490000;65535;1836751;1902286;1705681;0.008324;quickSort
110800;12276640000;65535;1838351;1903886;1707281;0.008381;quickSort
110900;12298810000;65535;1839951;1905486;1708881;0.008397;quickSort
111000;12321000000;65535;1841551;1907086;1710481;0.008487;quickSort
111100;12343210000;65535;1843151;1908686;1712081;0.008360;quickSort
111200;12365440000;65535;1844751;1910286;1713681;0.008409;quickSort
111300;12387690000;65535;1846351;1911886;1715281;0.008367;quickSort
111400;12409960000;65535;1847951;1913486;1716881;0.008608;quickSort
111500;12432250000;65535;1849551;1915086;1718481;0.008385;quickSort
111600;12454560000;65535;1851151;1916686;1720081;0.008395;quickSort
111700;12476890000;65535;1852751;1918286;1721681;0.009702;quickSort
111800;12499240000;65535;1854351;1919886;1723281;0.009048;quickSort
111900;12521610000;65535;1855951;1921486;1724881;0.008411;quickSort
112000;12544000000;65535;1857551;1923086;1726481;0.008443;quickSort
112100;12566410000;65535;1859151;1924686;1728081;0.008426;quickSort
112200;12588840000;65535;1860751;1926286;1729681;0.008444;quickSort
112300;12611290000;65535;1862351;1927886;1731281;0.008525;quickSort
112400;12633760000;65535;1863951;1929486;1732881;0.008429;quickSort
112500;12656250000;65535;1865551;1931086;1734481;0.009030;quickSort
112600;12678760000;65535;1867151;1932686;1736081;0.008437;quickSort
112700;12701290000;65535;1868751;1934286;1737681;0.008494;quickSort
112800;12723840000;65535;1870351;1935886;1739281;0.008547;quickSort
112900;12746410000;65535;1871951;1937486;1740881;0.009251;quickSort
113000;12769000000;65535;1873551;1939086;1742481;0.008453;quickSort
113100;12791610000;65535;1875151;1940686;1744081;0.009014;quickSort
113200;12814240000;65535;1876751;1942286;1745681;0.008453;quickSort
113300;12836890000;65535;1878351;1943886;1747281;0.008447;quickSort
113400;12859560000;65535;1879951;1945486;1748881;0.008491;quickSort
113500;12882250000;65535;1881551;1947086;1750481;0.008495;quickSort
113600;12904960000;65535;1883151;1948686;1752081;0.009869;quickSort
113700;12927690000;65535;1884751;1950286;1753681;0.009087;quickSort
113800;12950440000;65535;1886351;1951886;1755281;0.008504;quickSort
113900;12973210000;65535;1887951;1953486;1756881;0.009834;quickSort
114000;12996000000;65535;1889551;1955086;1758481;0.009519;quickSort
114100;13018810000;65535;1891151;1956686;1760081;0.008610;quickSort
114200;13041640000;65535;1892751;1958286;1761681;0.008574;quickSort
114300;13064490000;65535;1894351;1959886;1763281;0.008518;quickSort
114400;13087360000;65535;1895951;1961486;1764881;0.009115;quickSort
114500;13110250000;65535;1897551;1963086;1766481;0.009269;quickSort
114600;13133160000;65535;1899151;1964686;1768081;0.008676;quickSort
114700;13156090000;65535;1900751;1966286;1769681;0.008956;quickSort
114800;13179040000;65535;1902351;1967886;1771281;0.009354;quickSort
114900;13202010000;65535;1903951;1969486;1772881;0.009057;quickSort
115000;13225000000;65535;1905551;1971086;1774481;0.010613;quickSort
115100;13248010000;65535;1907151;1972686;1776081;0.009970;quickSort
115200;13271040000;65535;1908751;1974286;1777681;0.010037;quickSort
115300;13294090000;65535;1910351;1975886;1779281;0.009852;quickSort
115400;13317160000;65535;1911951;1977486;1780881;0.014847;quickSort
115500;13340250000;65535;1913551;1979086;1782481;0.021655;quickSort
115600;13363360000;65535;1915151;1980686;1784081;0.020363;quickSort
115700;13386490000;65535;1916751;1982286;1785681;0.013241;quickSort
115800;13409640000;65535;1918351;1983886;1787281;0.014289;quickSort
115900;13432810000;65535;1919951;1985486;1788881;0.010353;quickSort
116000;13456000000;65535;1921551;1987086;1790481;0.009897;quickSort
116100;13479210000;65535;1923151;1988686;1792081;0.011134;quickSort
116200;13502440000;65535;1924751;1990286;1793681;0.011936;quickSort
116300;13525690000;65535;1926351;1991886;1795281;0.011261;quickSort
116400;13548960000;65535;1927951;1993486;1796881;0.010176;quickSort
116500;13572250000;65535;1929551;1995086;1798481;0.009461;quickSort
116600;13595560000;65535;1931151;1996686;1800081;0.010088;quickSort
116700;13618890000;65535;1932751;1998286;1801681;0.009512;quickSort
116800;13642240000;65535;1934351;1999886;1803281;0.008700;quickSort
116900;13665610000;65535;1935951;2001486;1804881;0.008493;quickSort
117000;13689000000;65535;1937551;2003086;1806481;0.009002;quickSort
117100;13712410000;65535;1939151;2004686;1808081;0.009473;quickSort
117200;13735840000;65535;1940751;2006286;1809681;0.009394;quickSort
117300;13759290000;65535;1942351;2007886;1811281;0.008682;quickSort
117400;13782760000;65535;1943951;2009486;1812881;0.008869;quickSort
117500;13806250000;65535;1945551;2011086;1814481;0.008629;quickSort
117600;13829760000;65535;1947151;2012686;1816081;0.008725;quickSort
117700;13853290000;65535;1948751;2014286;1817681;0.008586;quickSort
117800;13876840000;65535;1950351;2015886;1819281;0.008968;quickSort
117900;13900410000;65535;1951951;2017486;1820881;0.009995;quickSort
118000;13924000000;65535;1953551;2019086;1822481;0.009261;quickSort
118100;13947610000;65535;1955151;2020686;1824081;0.009490;quickSort
118200;13971240000;65535;1956751;2022286;1825681;0.009873;quickSort
118300;13994890000;65535;1958351;2023886;1827281;0.009934;quickSort
118400;14018560000;65535;1959951;2025486;1828881;0.009113;quickSort
118500;14042250000;65535;1961551;2027086;1830481;0.011401;quickSort
118600;14065960000;65535;1963151;2028686;1832081;0.010773;quickSort
118700;14089690000;65535;1964751;2030286;1833681;0.009305;quickSort
118800;14113440000;65535;1966351;2031886;1835281;0.009723;quickSort
118900;14137210000;65535;1967951;2033486;1836881;0.009772;quickSort
119000;14161000000;65535;1969551;2035086;1838481;0.010137;quickSort
119100;14184810000;65535;1971151;2036686;1840081;0.009351;quickSort
119200;14208640000;65535;1972751;2038286;1841681;0.010168;quickSort
119300;14232490000;65535;1974351;2039886;1843281;0.010717;quickSort
119400;14256360000;65535;1975951;2041486;1844881;0.009759;quickSort
119500;14280250000;65535;1977551;2043086;1846481;0.008820;quickSort
119600;14304160000;65535;1979151;2044686;1848081;0.008934;quickSort
119700;14328090000;65535;1980751;2046286;1849681;0.013192;quickSort
119800;14352040000;65535;1982351;2047886;1851281;0.010549;quickSort
119900;14376010000;65535;1983951;2049486;1852881;0.011010;quickSort
120000;14400000000;65535;1985551;2051086;1854481;0.008992;quickSort
120100;14424010000;65535;1987151;2052686;1856081;0.011420;quickSort
120200;14448040000;65535;1988751;2054286;1857681;0.009107;quickSort
120300;14472090000;65535;1990351;2055886;1859281;0.009213;quickSort
120400;14496160000;65535;1991951;2057486;1860881;0.009009;quickSort
120500;14520250000;65535;1993551;2059086;1862481;0.009099;quickSort
120600;14544360000;65535;1995151;2060686;1864081;0.008960;quickSort
120700;14568490000;65535;1996751;2062286;1865681;0.008977;quickSort
120800;14592640000;65535;1998351;2063886;1867281;0.009267;quickSort
120900;14616810000;65535;1999951;2065486;1868881;0.009034;quickSort
121000;14641000000;65535;2001551;2067086;1870481;0.008932;quickSort
121100;14665210000;65535;2003151;2068686;1872081;0.008979;quickSort
121200;14689440000;65535;2004751;2070286;1873681;0.008942;quickSort
121300;14713690000;65535;2006351;2071886;1875281;0.008948;quickSort
121400;14737960000;65535;2007951;2073486;1876881;0.008956;quickSort
121500;14762250000;65535;2009551;2075086;1878481;0.008979;quickSort
121600;14786560000;65535;2011151;2076686;1880081;0.009119;quickSort
121700;14810890000;65535;2012751;2078286;1881681;0.009237;quickSort
121800;14835240000;65535;2014351;2079886;1883281;0.010982;quickSort
121900;14859610000;65535;2015951;2081486;1884881;0.011073;quickSort
122000;14884000000;65535;2017551;2083086;1886481;0.009653;quickSort
122100;14908410000;65535;2019151;2084686;1888081;0.008975;quickSort
122200;14932840000;65535;2020751;2086286;1889681;0.009003;quickSort
122300;14957290000;65535;2022351;2087886;1891281;0.009137;quickSort
122400;14981760000;65535;2023951;2089486;1892881;0.008967;quickSort
122500;15006250000;65535;2025551;2091086;1894481;0.011080;quickSort
122600;15030760000;65535;2027151;2092686;1896081;0.009033;quickSort
122700;15055290000;65535;2028751;2094286;1897681;0.009024;quickSort
122800;15079840000;65535;2030351;2095886;1899281;0.009000;quickSort
122900;15104410000;65535;2031951;2097486;1900881;0.009623;quickSort
123000;15129000000;65535;2033551;2099086;1902481;0.009039;quickSort
123100;15153610000;65535;2035151;2100686;1904081;0.009007;quickSort
123200;15178240000;65535;2036751;2102286;1905681;0.009045;quickSort
123300;15202890000;65535;2038351;2103886;1907281;0.009027;quickSort
123400;15227560000;65535;2039951;2105486;1908881;0.009074;quickSort
123500;15252250000;65535;2041551;2107086;1910481;0.009087;quickSort
123600;15276960000;65535;2043151;2108686;1912081;0.009069;quickSort
123700;15301690000;65535;2044751;2110286;1913681;0.009120;quickSort
123800;15326440000;65535;2046351;2111886;1915281;0.009472;quickSort
123900;15351210000;65535;2047951;2113486;1916881;0.009099;quickSort
124000;15376000000;65535;2049551;2115086;1918481;0.009128;quickSort
124100;15400810000;65535;2051151;2116686;1920081;0.009129;quickSort
124200;15425640000;65535;2052751;2118286;1921681;0.009451;quickSort
124300;15450490000;65535;2054351;2119886;1923281;0.009122;quickSort
124400;15475360000;65535;2055951;2121486;1924881;0.009157;quickSort
124500;15500250000;65535;2057551;2123086;1926481;0.009725;quickSort
124600;15525160000;65535;2059151;2124686;1928081;0.009125;quickSort
124700;15550090000;65535;2060751;2126286;1929681;0.009146;quickSort
124800;15575040000;65535;2062351;2127886;1931281;0.009144;quickSort
124900;15600010000;65535;2063951;2129486;1932881;0.009395;quickSort
125000;15625000000;65535;2065551;2131086;1934481;0.011390;quickSort
125100;15650010000;65535;2067151;2132686;1936081;0.017236;quickSort
125200;15675040000;65535;2068751;2134286;1937681;0.009193;quickSort
125300;15700090000;65535;2070351;2135886;1939281;0.009219;quickSort
125400;15725160000;65535;2071951;2137486;1940881;0.009177;quickSort
125500;15750250000;65535;2073551;2139086;1942481;0.009199;quickSort
125600;15775360000;65535;2075151;2140686;1944081;0.010354;quickSort
125700;15800490000;65535;2076751;2142286;1945681;0.009214;quickSort
125800;15825640000;65535;2078351;2143886;1947281;0.009720;quickSort
125900;15850810000;65535;2079951;2145486;1948881;0.009013;quickSort
126000;15876000000;65535;2081551;2147086;1950481;0.009081;quickSort
126100;15901210000;65535;2083151;2148686;1952081;0.008994;quickSort
126200;15926440000;65535;2084751;2150286;1953681;0.009127;quickSort
126300;15951690000;65535;2086351;2151886;1955281;0.009028;quickSort
126400;15976960000;65535;2087951;2153486;1956881;0.009240;quickSort
126500;16002250000;65535;2089551;2155086;1958481;0.009032;quickSort
126600;16027560000;65535;2091151;2156686;1960081;0.009034;quickSort
126700;16052890000;65535;2092751;2158286;1961681;0.009029;quickSort
126800;16078240000;65535;2094351;2159886;1963281;0.009039;quickSort
126900;16103610000;65535;2095951;2161486;1964881;0.009040;quickSort
127000;16129000000;65535;2097551;2163086;1966481;0.009674;quickSort
127100;16154410000;65535;2099151;2164686;1968081;0.009315;quickSort
127200;16179840000;65535;2100751;2166286;1969681;0.009306;quickSort
127300;16205290000;65535;2102351;2167886;1971281;0.009837;quickSort
127400;16230760000;65535;2103951;2169486;1972881;0.009539;quickSort
127500;16256250000;65535;2105551;2171086;1974481;0.009480;quickSort
127600;16281760000;65535;2107151;2172686;1976081;0.009476;quickSort
127700;16307290000;65535;2108751;2174286;1977681;0.009350;quickSort
127800;16332840000;65535;2110351;2175886;1979281;0.009325;quickSort
127900;16358410000;65535;2111951;2177486;1980881;0.009345;quickSort
128000;16384000000;65535;2113551;2179086;1982481;0.009340;quickSort
128100;16409610000;65535;2115151;2180686;1984081;0.009348;quickSort
128200;16435240000;65535;2116751;2182286;1985681;0.009362;quickSort
128300;16460890000;65535;2118351;2183886;1987281;0.009545;quickSort
128400;16486560000;65535;2119951;2185486;1988881;0.009346;quickSort
128500;16512250000;65535;2121551;2187086;1990481;0.009364;quickSort
128600;16537960000;65535;2123151;2188686;1992081;0.009556;quickSort
128700;16563690000;65535;2124751;2190286;1993681;0.009447;quickSort
128800;16589440000;65535;2126351;2191886;1995281;0.009403;quickSort
128900;16615210000;65535;2127951;2193486;1996881;0.009503;quickSort
129000;16641000000;65535;2129551;2195086;1998481;0.009171;quickSort
129100;16666810000;65535;2131151;2196686;2000081;0.009469;quickSort
129200;16692640000;65535;2132751;2198286;2001681;0.009424;quickSort
129300;16718490000;65535;2134351;2199886;2003281;0.009407;quickSort
129400;16744360000;65535;2135951;2201486;2004881;0.009451;quickSort
129500;16770250000;65535;2137551;2203086;2006481;0.009630;quickSort
129600;16796160000;65535;2139151;2204686;2008081;0.009429;quickSort
129700;16822090000;65535;2140751;2206286;2009681;0.009437;quickSort
129800;16848040000;65535;2142351;2207886;2011281;0.009826;quickSort
129900;16874010000;65535;2143951;2209486;2012881;0.009464;quickSort
130000;16900000000;65535;2145551;2211086;2014481;0.009471;quickSort
130100;16926010000;65535;2147151;2212686;2016081;0.009457;quickSort
130200;16952040000;65535;2148751;2214286;2017681;0.009449;quickSort
130300;16978090000;65535;2150351;2215886;2019281;0.009489;quickSort
130400;17004160000;65535;2151951;2217486;2020881;0.009584;quickSort
130500;17030250000;65535;2153551;2219086;2022481;0.009517;quickSort
130600;17056360000;65535;2155151;2220686;2024081;0.009464;quickSort
130700;17082490000;65535;2156751;2222286;2025681;0.009497;quickSort
130800;17108640000;65535;2158351;2223886;2027281;0.009800;quickSort
130900;17134810000;65535;2159951;2225486;2028881;0.009501;quickSort
131000;17161000000;65535;2161551;2227086;2030481;0.009506;quickSort
131100;17187210000;65564;2163267;2228831;2032139;0.009755;quickSort
131200;17213440000;65664;2165267;2230931;2033939;0.009511;quickSort
131300;17239690000;65764;2167267;2233031;2035739;0.010191;quickSort
131400;17265960000;65864;2169267;2235131;2037539;0.009598;quickSort
131500;17292250000;65964;2171267;2237231;2039339;0.009673;quickSort
131600;17318560000;66064;2173267;2239331;2041139;0.009565;quickSort
131700;17344890000;66164;2175267;2241431;2042939;0.009567;quickSort
131800;17371240000;66264;2177267;2243531;2044739;0.009608;quickSort
131900;17397610000;66364;2179267;2245631;2046539;0.009626;quickSort
132000;17424000000;66464;2181267;2247731;2048339;0.009573;quickSort
132100;17450410000;66564;2183267;2249831;2050139;0.009646;quickSort
132200;17476840000;66664;2185267;2251931;2051939;0.009659;quickSort
132300;17503290000;66764;2187267;2254031;2053739;0.009633;quickSort
132400;17529760000;66864;2189267;2256131;2055539;0.009653;quickSort
132500;17556250000;66964;2191267;2258231;2057339;0.009706;quickSort
132600;17582760000;67064;2193267;2260331;2059139;0.009689;quickSort
132700;17609290000;67164;2195267;2262431;2060939;0.009681;quickSort
132800;17635840000;67264;2197267;2264531;2062739;0.009714;quickSort
132900;17662410000;67364;2199267;2266631;2064539;0.009700;quickSort
133000;17689000000;67464;2201267;2268731;2066339;0.009733;quickSort
133100;17715610000;67564;2203267;2270831;2068139;0.009739;quickSort
133200;17742240000;67664;2205267;2272931;2069939;0.009740;quickSort
133300;17768890000;67764;2207267;2275031;2071739;0.009804;quickSort
133400;17795560000;67864;2209267;2277131;2073539;0.009847;quickSort
133500;17822250000;67964;2211267;2279231;2075339;0.009590;quickSort
133600;17848960000;68064;2213267;2281331;2077139;0.009576;quickSort
133700;17875690000;68164;2215267;2283431;2078939;0.009612;quickSort
133800;17902440000;68264;2217267;2285531;2080739;0.009589;quickSort
133900;17929210000;68364;2219267;2287631;2082539;0.009652;quickSort
134000;17956000000;68464;2221267;2289731;2084339;0.009838;quickSort
134100;17982810000;68564;2223267;2291831;2086139;0.009933;quickSort
134200;18009640000;68664;2225267;2293931;2087939;0.009891;quickSort
134300;18036490000;68764;2227267;2296031;2089739;0.010420;quickSort
134400;18063360000;68864;2229267;2298131;2091539;0.011212;quickSort
134500;18090250000;68964;2231267;2300231;2093339;0.009890;quickSort
134600;18117160000;69064;2233267;2302331;2095139;0.009884;quickSort
134700;18144090000;69164;2235267;2304431;2096939;0.009936;quickSort
134800;18171040000;69264;2237267;2306531;2098739;0.009901;quickSort
134900;18198010000;69364;2239267;2308631;2100539;0.009893;quickSort
135000;18225000000;69464;2241267;2310731;2102339;0.011067;quickSort
135100;18252010000;69564;2243267;2312831;2104139;0.010169;quickSort
135200;18279040000;69664;2245267;2314931;2105939;0.010021;quickSort
135300;18306090000;69764;2247267;2317031;2107739;0.010046;quickSort
135400;18333160000;69864;2249267;2319131;2109539;0.010027;quickSort
135500;18360250000;69964;2251267;2321231;2111339;0.010058;quickSort
135600;18387360000;70064;2253267;2323331;2113139;0.011110;quickSort
135700;18414490000;70164;2255267;2325431;2114939;0.010355;quickSort
135800;18441640000;70264;2257267;2327531;2116739;0.010046;quickSort
135900;18468810000;70364;2259267;2329631;2118539;0.010047;quickSort
136000;18496000000;70464;2261267;2331731;2120339;0.010057;quickSort
136100;18523210000;70564;2263267;2333831;2122139;0.010076;quickSort
136200;18550440000;70664;2265267;2335931;2123939;0.012036;quickSort
136300;18577690000;70764;2267267;2338031;2125739;0.010247;quickSort
136400;18604960000;70864;2269267;2340131;2127539;0.010187;quickSort
136500;18632250000;70964;2271267;2342231;2129339;0.010752;quickSort
136600;18659560000;71064;2273267;2344331;2131139;0.010144;quickSort
136700;18686890000;71164;2275267;2346431;2132939;0.011149;quickSort
136800;18714240000;71264;2277267;2348531;2134739;0.010188;quickSort
136900;18741610000;71364;2279267;2350631;2136539;0.010201;quickSort
137000;18769000000;71464;2281267;2352731;2138339;0.010173;quickSort
137100;18796410000;71564;2283267;2354831;2140139;0.010160;quickSort
137200;18823840000;71664;2285267;2356931;2141939;0.010151;quickSort
137300;18851290000;71764;2287267;2359031;2143739;0.010366;quickSort
137400;18878760000;71864;2289267;2361131;2145539;0.010216;quickSort
137500;18906250000;71964;2291267;2363231;2147339;0.010233;quickSort
137600;18933760000;72064;2293267;2365331;2149139;0.010222;quickSort
137700;18961290000;72164;2295267;2367431;2150939;0.010229;quickSort
137800;18988840000;72264;2297267;2369531;2152739;0.010276;quickSort
137900;19016410000;72364;2299267;2371631;2154539;0.010245;quickSort
138000;19044000000;72464;2301267;2373731;2156339;0.010136;quickSort
138100;19071610000;72564;2303267;2375831;2158139;0.010030;quickSort
138200;19099240000;72664;2305267;2377931;2159939;0.009991;quickSort
138300;19126890000;72764;2307267;2380031;2161739;0.010016;quickSort
138400;19154560000;72864;2309267;2382131;2163539;0.010647;quickSort
138500;19182250000;72964;2311267;2384231;2165339;0.010316;quickSort
138600;19209960000;73064;2313267;2386331;2167139;0.010328;quickSort
138700;19237690000;73164;2315267;2388431;2168939;0.010412;quickSort
138800;19265440000;73264;2317267;2390531;2170739;0.010315;quickSort
138900;19293210000;73364;2319267;2392631;2172539;0.010342;quickSort
139000;19321000000;73464;2321267;2394731;2174339;0.010576;quickSort
139100;19348810000;73564;2323267;2396831;2176139;0.010372;quickSort
139200;19376640000;73664;2325267;2398931;2177939;0.010363;quickSort
139300;19404490000;73764;2327267;2401031;2179739;0.010350;quickSort
139400;19432360000;73864;2329267;2403131;2181539;0.010393;quickSort
139500;19460250000;73964;2331267;2405231;2183339;0.010391;quickSort
139600;19488160000;74064;2333267;2407331;2185139;0.010377;quickSort
139700;19516090000;74164;2335267;2409431;2186939;0.010384;quickSort
139800;19544040000;74264;2337267;2411531;2188739;0.010415;quickSort
139900;19572010000;74364;2339267;2413631;2190539;0.010427;quickSort
140000;19600000000;74464;2341267;2415731;2192339;0.010425;quickSort
140100;19628010000;74564;2343267;2417831;2194139;0.010505;quickSort
140200;19656040000;74664;2345267;2419931;2195939;0.011277;quickSort
140300;19684090000;74764;2347267;2422031;2197739;0.010449;quickSort
140400;19712160000;74864;2349267;2424131;2199539;0.010611;quickSort
140500;19740250000;74964;2351267;2426231;2201339;0.010542;quickSort
140600;19768360000;75064;2353267;2428331;2203139;0.010503;quickSort
140700;19796490000;75164;2355267;2430431;2204939;0.010541;quickSort
140800;19824640000;75264;2357267;2432531;2206739;0.010234;quickSort
140900;19852810000;75364;2359267;2434631;2208539;0.010263;quickSort
141000;19881000000;75464;2361267;2436731;2210339;0.010263;quickSort
141100;19909210000;75564;2363267;2438831;2212139;0.010263;quickSort
141200;19937440000;75664;2365267;2440931;2213939;0.010334;quickSort
141300;19965690000;75764;2367267;2443031;2215739;0.010540;quickSort
141400;19993960000;75864;2369267;2445131;2217539;0.010580;quickSort
141500;20022250000;75964;2371267;2447231;2219339;0.010600;quickSort
141600;20050560000;76064;2373267;2449331;2221139;0.010554;quickSort
141700;20078890000;76164;2375267;2451431;2222939;0.010634;quickSort
141800;20107240000;76264;2377267;2453531;2224739;0.010613;quickSort
141900;20135610000;76364;2379267;2455631;2226539;0.010598;quickSort
142000;20164000000;76464;2381267;2457731;2228339;0.010625;quickSort
142100;20192410000;76564;2383267;2459831;2230139;0.010631;quickSort
142200;20220840000;76664;2385267;2461931;2231939;0.010747;quickSort
142300;20249290000;76764;2387267;2464031;2233739;0.010661;quickSort
142400;20277760000;76864;2389267;2466131;2235539;0.010627;quickSort
142500;20306250000;76964;2391267;2468231;2237339;0.011083;quickSort
142600;20334760000;77064;2393267;2470331;2239139;0.010672;quickSort
142700;20363290000;77164;2395267;2472431;2240939;0.010737;quickSort
142800;20391840000;77264;2397267;2474531;2242739;0.010697;quickSort
142900;20420410000;77364;2399267;2476631;2244539;0.010706;quickSort
143000;20449000000;77464;2401267;2478731;2246339;0.010698;quickSort
143100;20477610000;77564;2403267;2480831;2248139;0.010722;quickSort
143200;20506240000;77664;2405267;2482931;2249939;0.010767;quickSort
143300;20534890000;77764;2407267;2485031;2251739;0.010754;quickSort
143400;20563560000;77864;2409267;2487131;2253539;0.010758;quickSort
143500;20592250000;77964;2411267;2489231;2255339;0.010764;quickSort
143600;20620960000;78064;2413267;2491331;2257139;0.012653;quickSort
143700;20649690000;78164;2415267;2493431;2258939;0.010796;quickSort
143800;20678440000;78264;2417267;2495531;2260739;0.010774;quickSort
143900;20707210000;78364;2419267;2497631;2262539;0.010821;quickSort
144000;20736000000;78464;2421267;2499731;2264339;0.010944;quickSort
144100;20764810000;78564;2423267;2501831;2266139;0.010826;quickSort
144200;20793640000;78664;2425267;2503931;2267939;0.010872;quickSort
144300;20822490000;78764;2427267;2506031;2269739;0.010834;quickSort
144400;20851360000;78864;2429267;2508131;2271539;0.012490;quickSort
144500;20880250000;78964;2431267;2510231;2273339;0.010849;quickSort
144600;20909160000;79064;2433267;2512331;2275139;0.010832;quickSort
144700;20938090000;79164;2435267;2514431;2276939;0.010873;quickSort
144800;20967040000;79264;2437267;2516531;2278739;0.010871;quickSort
144900;20996010000;79364;2439267;2518631;2280539;0.010875;quickSort
145000;21025000000;79464;2441267;2520731;2282339;0.010897;quickSort
145100;21054010000;79564;2443267;2522831;2284139;0.011016;quickSort
145200;21083040000;79664;2445267;2524931;2285939;0.010902;quickSort
145300;21112090000;79764;2447267;2527031;2287739;0.011573;quickSort
145400;21141160000;79864;2449267;2529131;2289539;0.010943;quickSort
145500;21170250000;79964;2451267;2531231;2291339;0.010993;quickSort
145600;21199360000;80064;2453267;2533331;2293139;0.010918;quickSort
145700;21228490000;80164;2455267;2535431;2294939;0.011572;quickSort
145800;21257640000;80264;2457267;2537531;2296739;0.010969;quickSort
145900;21286810000;80364;2459267;2539631;2298539;0.011014;quickSort
146000;21316000000;80464;2461267;2541731;2300339;0.010961;quickSort
146100;21345210000;80564;2463267;2543831;2302139;0.010957;quickSort
146200;21374440000;80664;2465267;2545931;2303939;0.011569;quickSort
146300;21403690000;80764;2467267;2548031;2305739;0.011046;quickSort
146400;21432960000;80864;2469267;2550131;2307539;0.011031;quickSort
146500;21462250000;80964;2471267;2552231;2309339;0.010994;quickSort
146600;21491560000;81064;2473267;2554331;2311139;0.011543;quickSort
146700;21520890000;81164;2475267;2556431;2312939;0.011019;quickSort
146800;21550240000;81264;2477267;2558531;2314739;0.011029;quickSort
146900;21579610000;81364;2479267;2560631;2316539;0.011024;quickSort
147000;21609000000;81464;2481267;2562731;2318339;0.011023;quickSort
147100;21638410000;81564;2483267;2564831;2320139;0.011060;quickSort
147200;21667840000;81664;2485267;2566931;2321939;0.011058;quickSort
147300;21697290000;81764;2487267;2569031;2323739;0.011092;quickSort
147400;21726760000;81864;2489267;2571131;2325539;0.011127;quickSort
147500;21756250000;81964;2491267;2573231;2327339;0.011065;quickSort
147600;21785760000;82064;2493267;2575331;2329139;0.011506;quickSort
147700;21815290000;82164;2495267;2577431;2330939;0.011082;quickSort
147800;21844840000;82264;2497267;2579531;2332739;0.011283;quickSort
147900;21874410000;82364;2499267;2581631;2334539;0.011127;quickSort
148000;21904000000;82464;2501267;2583731;2336339;0.011119;quickSort
148100;21933610000;82564;2503267;2585831;2338139;0.011158;quickSort
148200;21963240000;82664;2505267;2587931;2339939;0.011168;quickSort
148300;21992890000;82764;2507267;2590031;2341739;0.011182;quickSort
148400;22022560000;82864;2509267;2592131;2343539;0.012633;quickSort
148500;22052250000;82964;2511267;2594231;2345339;0.011207;quickSort
148600;22081960000;83064;2513267;2596331;2347139;0.011208;quickSort
148700;22111690000;83164;2515267;2598431;2348939;0.011194;quickSort
148800;22141440000;83264;2517267;2600531;2350739;0.011225;quickSort
148900;22171210000;83364;2519267;2602631;2352539;0.011226;quickSort
149000;22201000000;83464;2521267;2604731;2354339;0.011295;quickSort
149100;22230810000;83564;2523267;2606831;2356139;0.011495;quickSort
149200;22260640000;83664;2525267;2608931;2357939;0.011338;quickSort
149300;22290490000;83764;2527267;2611031;2359739;0.011328;quickSort
149400;22320360000;83864;2529267;2613131;2361539;0.011380;quickSort
149500;22350250000;83964;2531267;2615231;2363339;0.011414;quickSort
149600;22380160000;84064;2533267;2617331;2365139;0.011028;quickSort
149700;22410090000;84164;2535267;2619431;2366939;0.011000;quickSort
149800;22440040000;84264;2537267;2621531;2368739;0.011361;quickSort
149900;22470010000;84364;2539267;2623631;2370539;0.011341;quickSort
150000;22500000000;84464;2541267;2625731;2372339;0.011343;quickSort
150100;22530010000;84564;2543267;2627831;2374139;0.011346;quickSort
150200;22560040000;84664;2545267;2629931;2375939;0.011339;quickSort
150300;22590090000;84764;2547267;2632031;2377739;0.011421;quickSort
150400;22620160000;84864;2549267;2634131;2379539;0.011359;quickSort
150500;22650250000;84964;2551267;2636231;2381339;0.011437;quickSort
150600;22680360000;85064;2553267;2638331;2383139;0.011421;quickSort
150700;22710490000;85164;2555267;2640431;2384939;0.011410;quickSort
150800;22740640000;85264;2557267;2642531;2386739;0.011473;quickSort
150900;22770810000;85364;2559267;2644631;2388539;0.012057;quickSort
151000;22801000000;85464;2561267;2646731;2390339;0.011478;quickSort
151100;22831210000;85564;2563267;2648831;2392139;0.011480;quickSort
151200;22861440000;85664;2565267;2650931;2393939;0.011480;quickSort
151300;22891690000;85764;2567267;2653031;2395739;0.011477;quickSort
151400;22921960000;85864;2569267;2655131;2397539;0.011511;quickSort
151500;22952250000;85964;2571267;2657231;2399339;0.011493;quickSort
151600;22982560000;86064;2573267;2659331;2401139;0.011496;quickSort
151700;23012890000;86164;2575267;2661431;2402939;0.011514;quickSort
151800;23043240000;86264;2577267;2663531;2404739;0.011562;quickSort
151900;23073610000;86364;2579267;2665631;2406539;0.011515;quickSort
152000;23104000000;86464;2581267;2667731;2408339;0.011546;quickSort
152100;23134410000;86564;2583267;2669831;2410139;0.011550;quickSort
152200;23164840000;86664;2585267;2671931;2411939;0.011557;quickSort
152300;23195290000;86764;2587267;2674031;2413739;0.011622;quickSort
152400;23225760000;86864;2589267;2676131;2415539;0.011697;quickSort
152500;23256250000;86964;2591267;2678231;2417339;0.011615;quickSort
152600;23286760000;87064;2593267;2680331;2419139;0.011611;quickSort
152700;23317290000;87164;2595267;2682431;2420939;0.012745;quickSort
152800;23347840000;87264;2597267;2684531;2422739;0.011622;quickSort
152900;23378410000;87364;2599267;2686631;2424539;0.011604;quickSort
153000;23409000000;87464;2601267;2688731;2426339;0.011712;quickSort
153100;23439610000;87564;2603267;2690831;2428139;0.013996;quickSort
153200;23470240000;87664;2605267;2692931;2429939;0.011657;quickSort
153300;23500890000;87764;2607267;2695031;2431739;0.011641;quickSort
153400;23531560000;87864;2609267;2697131;2433539;0.011651;quickSort
153500;23562250000;87964;2611267;2699231;2435339;0.011680;quickSort
153600;23592960000;88064;2613267;2701331;2437139;0.011666;quickSort
153700;23623690000;88164;2615267;2703431;2438939;0.011706;quickSort
153800;23654440000;88264;2617267;2705531;2440739;0.011713;quickSort
153900;23685210000;88364;2619267;2707631;2442539;0.011803;quickSort
154000;23716000000;88464;2621267;2709731;2444339;0.011752;quickSort
154100;23746810000;88564;2623267;2711831;2446139;0.012203;quickSort
154200;23777640000;88664;2625267;2713931;2447939;0.011442;quickSort
154300;23808490000;88764;2627267;2716031;2449739;0.011456;quickSort
154400;23839360000;88864;2629267;2718131;2451539;0.011457;quickSort
154500;23870250000;88964;2631267;2720231;2453339;0.011454;quickSort
154600;23901160000;89064;2633267;2722331;2455139;0.012268;quickSort
154700;23932090000;89164;2635267;2724431;2456939;0.011838;quickSort
154800;23963040000;89264;2637267;2726531;2458739;0.011782;quickSort
154900;23994010000;89364;2639267;2728631;2460539;0.011836;quickSort
155000;24025000000;89464;2641267;2730731;2462339;0.011837;quickSort
155100;24056010000;89564;2643267;2732831;2464139;0.011857;quickSort
155200;24087040000;89664;2645267;2734931;2465939;0.011831;quickSort
155300;24118090000;89764;2647267;2737031;2467739;0.011861;quickSort
155400;24149160000;89864;2649267;2739131;2469539;0.012179;quickSort
155500;24180250000;89964;2651267;2741231;2471339;0.011860;quickSort
155600;24211360000;90064;2653267;2743331;2473139;0.011880;quickSort
155700;24242490000;90164;2655267;2745431;2474939;0.011850;quickSort
155800;24273640000;90264;2657267;2747531;2476739;0.011888;quickSort
155900;24304810000;90364;2659267;2749631;2478539;0.012091;quickSort
156000;24336000000;90464;2661267;2751731;2480339;0.012054;quickSort
156100;24367210000;90564;2663267;2753831;2482139;0.011918;quickSort
156200;24398440000;90664;2665267;2755931;2483939;0.011909;quickSort
156300;24429690000;90764;2667267;2758031;2485739;0.011949;quickSort
156400;24460960000;90864;2669267;2760131;2487539;0.011938;quickSort
156500;24492250000;90964;2671267;2762231;2489339;0.011959;quickSort
156600;24523560000;91064;2673267;2764331;2491139;0.011962;quickSort
156700;24554890000;91164;2675267;2766431;2492939;0.012059;quickSort
156800;24586240000;91264;2677267;2768531;2494739;0.012133;quickSort
156900;24617610000;91364;2679267;2770631;2496539;0.011988;quickSort
157000;24649000000;91464;2681267;2772731;2498339;0.012047;quickSort
157100;24680410000;91564;2683267;2774831;2500139;0.012457;quickSort
157200;24711840000;91664;2685267;2776931;2501939;0.012014;quickSort
157300;24743290000;91764;2687267;2779031;2503739;0.012073;quickSort
157400;24774760000;91864;2689267;2781131;2505539;0.012072;quickSort
157500;24806250000;91964;2691267;2783231;2507339;0.012371;quickSort
157600;24837760000;92064;2693267;2785331;2509139;0.012103;quickSort
157700;24869290000;92164;2695267;2787431;2510939;0.012115;quickSort
157800;24900840000;92264;2697267;2789531;2512739;0.012090;quickSort
157900;24932410000;92364;2699267;2791631;2514539;0.012103;quickSort
158000;24964000000;92464;2701267;2793731;2516339;0.012123;quickSort
158100;24995610000;92564;2703267;2795831;2518139;0.012153;quickSort
158200;25027240000;92664;2705267;2797931;2519939;0.012229;quickSort
158300;25058890000;92764;2707267;2800031;2521739;0.012284;quickSort
158400;25090560000;92864;2709267;2802131;2523539;0.012320;quickSort
158500;25122250000;92964;2711267;2804231;2525339;0.012296;quickSort
158600;25153960000;93064;2713267;2806331;2527139;0.012255;quickSort
158700;25185690000;93164;2715267;2808431;2528939;0.012257;quickSort
158800;25217440000;93264;2717267;2810531;2530739;0.012085;quickSort
158900;25249210000;93364;2719267;2812631;2532539;0.011888;quickSort
159000;25281000000;93464;2721267;2814731;2534339;0.012019;quickSort
159100;25312810000;93564;2723267;2816831;2536139;0.012218;quickSort
159200;25344640000;93664;2725267;2818931;2537939;0.012220;quickSort
159300;25376490000;93764;2727267;2821031;2539739;0.012238;quickSort
159400;25408360000;93864;2729267;2823131;2541539;0.012422;quickSort
159500;25440250000;93964;2731267;2825231;2543339;0.012269;quickSort
159600;25472160000;94064;2733267;2827331;2545139;0.012274;quickSort
159700;25504090000;94164;2735267;2829431;2546939;0.012370;quickSort
159800;25536040000;94264;2737267;2831531;2548739;0.012284;quickSort
159900;25568010000;94364;2739267;2833631;2550539;0.012311;quickSort
160000;25600000000;94464;2741267;2835731;2552339;0.012325;quickSort
160100;25632010000;94564;2743267;2837831;2554139;0.012701;quickSort
160200;25664040000;94664;2745267;2839931;2555939;0.012402;quickSort
160300;25696090000;94764;2747267;2842031;2557739;0.012363;quickSort
160400;25728160000;94864;2749267;2844131;2559539;0.012517;quickSort
160500;25760250000;94964;2751267;2846231;2561339;0.012463;quickSort
160600;25792360000;95064;2753267;2848331;2563139;0.012967;quickSort
160700;25824490000;95164;2755267;2850431;2564939;0.012379;quickSort
160800;25856640000;95264;2757267;2852531;2566739;0.012412;quickSort
160900;25888810000;95364;2759267;2854631;2568539;0.012521;quickSort
161000;25921000000;95464;2761267;2856731;2570339;0.014536;quickSort
161100;25953210000;95564;2763267;2858831;2572139;0.012423;quickSort
161200;25985440000;95664;2765267;2860931;2573939;0.012497;quickSort
161300;26017690000;95764;2767267;2863031;2575739;0.012512;quickSort
161400;26049960000;95864;2769267;2865131;2577539;0.012428;quickSort
161500;26082250000;95964;2771267;2867231;2579339;0.012781;quickSort
161600;26114560000;96064;2773267;2869331;2581139;0.012474;quickSort
161700;26146890000;96164;2775267;2871431;2582939;0.012492;quickSort
161800;26179240000;96264;2777267;2873531;2584739;0.012516;quickSort
161900;26211610000;96364;2779267;2875631;2586539;0.012488;quickSort
162000;26244000000;96464;2781267;2877731;2588339;0.012569;quickSort
162100;26276410000;96564;2783267;2879831;2590139;0.012767;quickSort
162200;26308840000;96664;2785267;2881931;2591939;0.012498;quickSort
162300;26341290000;96764;2787267;2884031;2593739;0.012577;quickSort
162400;26373760000;96864;2789267;2886131;2595539;0.012597;quickSort
162500;26406250000;96964;2791267;2888231;2597339;0.012539;quickSort
162600;26438760000;97064;2793267;2890331;2599139;0.012523;quickSort
162700;26471290000;97164;2795267;2892431;2600939;0.012527;quickSort
162800;26503840000;97264;2797267;2894531;2602739;0.013031;quickSort
162900;26536410000;97364;2799267;2896631;2604539;0.012536;quickSort
163000;26569000000;97464;2801267;2898731;2606339;0.012566;quickSort
163100;26601610000;97564;2803267;2900831;2608139;0.012586;quickSort
163200;26634240000;97664;2805267;2902931;2609939;0.012592;quickSort
163300;26666890000;97764;2807267;2905031;2611739;0.012602;quickSort
163400;26699560000;97864;2809267;2907131;2613539;0.012633;quickSort
163500;26732250000;97964;2811267;2909231;2615339;0.012623;quickSort
163600;26764960000;98064;2813267;2911331;2617139;0.012626;quickSort
163700;26797690000;98164;2815267;2913431;2618939;0.012612;quickSort
163800;26830440000;98264;2817267;2915531;2620739;0.012639;quickSort
163900;26863210000;98364;2819267;2917631;2622539;0.012713;quickSort
164000;26896000000;98464;2821267;2919731;2624339;0.012682;quickSort
164100;26928810000;98564;2823267;2921831;2626139;0.012657;quickSort
164200;26961640000;98664;2825267;2923931;2627939;0.012700;quickSort
164300;26994490000;98764;2827267;2926031;2629739;0.012692;quickSort
164400;27027360000;98864;2829267;2928131;2631539;0.012713;quickSort
164500;27060250000;98964;2831267;2930231;2633339;0.012727;quickSort
164600;27093160000;99064;2833267;2932331;2635139;0.012736;quickSort
164700;27126090000;99164;2835267;2934431;2636939;0.012755;quickSort
164800;27159040000;99264;2837267;2936531;2638739;0.014135;quickSort
164900;27192010000;99364;2839267;2938631;2640539;0.012782;quickSort
165000;27225000000;99464;2841267;2940731;2642339;0.012787;quickSort
165100;27258010000;99564;2843267;2942831;2644139;0.012797;quickSort
165200;27291040000;99664;2845267;2944931;2645939;0.012803;quickSort
165300;27324090000;99764;2847267;2947031;2647739;0.012845;quickSort
165400;27357160000;99864;2849267;2949131;2649539;0.012907;quickSort
165500;27390250000;99964;2851267;2951231;2651339;0.012850;quickSort
165600;27423360000;100064;2853267;2953331;2653139;0.013359;quickSort
165700;27456490000;100164;2855267;2955431;2654939;0.012886;quickSort
165800;27489640000;100264;2857267;2957531;2656739;0.015134;quickSort
165900;27522810000;100364;2859267;2959631;2658539;0.012882;quickSort
166000;27556000000;100464;2861267;2961731;2660339;0.012887;quickSort
166100;27589210000;100564;2863267;2963831;2662139;0.013158;quickSort
166200;27622440000;100664;2865267;2965931;2663939;0.012933;quickSort
166300;27655690000;100764;2867267;2968031;2665739;0.012935;quickSort
166400;27688960000;100864;2869267;2970131;2667539;0.012959;quickSort
166500;27722250000;100964;2871267;2972231;2669339;0.012967;quickSort
166600;27755560000;101064;2873267;2974331;2671139;0.012958;quickSort
166700;27788890000;101164;2875267;2976431;2672939;0.013023;quickSort
166800;27822240000;101264;2877267;2978531;2674739;0.013644;quickSort
166900;27855610000;101364;2879267;2980631;2676539;0.013019;quickSort
167000;27889000000;101464;2881267;2982731;2678339;0.013125;quickSort
167100;27922410000;101564;2883267;2984831;2680139;0.013036;quickSort
167200;27955840000;101664;2885267;2986931;2681939;0.013544;quickSort
167300;27989290000;101764;2887267;2989031;2683739;0.013048;quickSort
167400;28022760000;101864;2889267;2991131;2685539;0.013090;quickSort
167500;28056250000;101964;2891267;2993231;2687339;0.013124;quickSort
167600;28089760000;102064;2893267;2995331;2689139;0.013073;quickSort
167700;28123290000;102164;2895267;2997431;2690939;0.013568;quickSort
167800;28156840000;102264;2897267;2999531;2692739;0.013085;quickSort
167900;28190410000;102364;2899267;3001631;2694539;0.013140;quickSort
168000;28224000000;102464;2901267;3003731;2696339;0.013138;quickSort
168100;28257610000;102564;2903267;3005831;2698139;0.013166;quickSort
168200;28291240000;102664;2905267;3007931;2699939;0.013271;quickSort
168300;28324890000;102764;2907267;3010031;2701739;0.013151;quickSort
168400;28358560000;102864;2909267;3012131;2703539;0.013213;quickSort
168500;28392250000;102964;2911267;3014231;2705339;0.013179;quickSort
168600;28425960000;103064;2913267;3016331;2707139;0.013204;quickSort
168700;28459690000;103164;2915267;3018431;2708939;0.013218;quickSort
168800;28493440000;103264;2917267;3020531;2710739;0.013300;quickSort
168900;28527210000;103364;2919267;3022631;2712539;0.013227;quickSort
169000;28561000000;103464;2921267;3024731;2714339;0.013237;quickSort
169100;28594810000;103564;2923267;3026831;2716139;0.013203;quickSort
169200;28628640000;103664;2925267;3028931;2717939;0.013276;quickSort
169300;28662490000;103764;2927267;3031031;2719739;0.013266;quickSort
169400;28696360000;103864;2929267;3033131;2721539;0.013288;quickSort
169500;28730250000;103964;2931267;3035231;2723339;0.013313;quickSort
169600;28764160000;104064;2933267;3037331;2725139;0.013962;quickSort
169700;28798090000;104164;2935267;3039431;2726939;0.013353;quickSort
169800;28832040000;104264;2937267;3041531;2728739;0.013378;quickSort
169900;28866010000;104364;2939267;3043631;2730539;0.013390;quickSort
170000;28900000000;104464;2941267;3045731;2732339;0.013352;quickSort
170100;28934010000;104564;2943267;3047831;2734139;0.013365;quickSort
170200;28968040000;104664;2945267;3049931;2735939;0.013374;quickSort
170300;29002090000;104764;2947267;3052031;2737739;0.013413;quickSort
170400;29036160000;104864;2949267;3054131;2739539;0.013434;quickSort
170500;29070250000;104964;2951267;3056231;2741339;0.013418;quickSort
170600;29104360000;105064;2953267;3058331;2743139;0.013429;quickSort
170700;29138490000;105164;2955267;3060431;2744939;0.013418;quickSort
170800;29172640000;105264;2957267;3062531;2746739;0.013327;quickSort
170900;29206810000;105364;2959267;3064631;2748539;0.013143;quickSort
171000;29241000000;105464;2961267;3066731;2750339;0.013115;quickSort
171100;29275210000;105564;2963267;3068831;2752139;0.013106;quickSort
171200;29309440000;105664;2965267;3070931;2753939;0.013481;quickSort
171300;29343690000;105764;2967267;3073031;2755739;0.013478;quickSort
171400;29377960000;105864;2969267;3075131;2757539;0.013519;quickSort
171500;29412250000;105964;2971267;3077231;2759339;0.013499;quickSort
171600;29446560000;106064;2973267;3079331;2761139;0.013534;quickSort
171700;29480890000;106164;2975267;3081431;2762939;0.013550;quickSort
171800;29515240000;106264;2977267;3083531;2764739;0.013588;quickSort
171900;29549610000;106364;2979267;3085631;2766539;0.013565;quickSort
172000;29584000000;106464;2981267;3087731;2768339;0.013588;quickSort
172100;29618410000;106564;2983267;3089831;2770139;0.013702;quickSort
172200;29652840000;106664;2985267;3091931;2771939;0.013699;quickSort
172300;29687290000;106764;2987267;3094031;2773739;0.014748;quickSort
172400;29721760000;106864;2989267;3096131;2775539;0.013623;quickSort
172500;29756250000;106964;2991267;3098231;2777339;0.013831;quickSort
172600;29790760000;107064;2993267;3100331;2779139;0.013895;quickSort
172700;29825290000;107164;2995267;3102431;2780939;0.013654;quickSort
172800;29859840000;107264;2997267;3104531;2782739;0.013640;quickSort
172900;29894410000;107364;2999267;3106631;2784539;0.013663;quickSort
173000;29929000000;107464;3001267;3108731;2786339;0.013641;quickSort
173100;29963610000;107564;3003267;3110831;2788139;0.013636;quickSort
173200;29998240000;107664;3005267;3112931;2789939;0.013696;quickSort
173300;30032890000;107764;3007267;3115031;2791739;0.013688;quickSort
173400;30067560000;107864;3009267;3117131;2793539;0.013698;quickSort
173500;30102250000;107964;3011267;3119231;2795339;0.013680;quickSort
173600;30136960000;108064;3013267;3121331;2797139;0.013815;quickSort
173700;30171690000;108164;3015267;3123431;2798939;0.013822;quickSort
173800;30206440000;108264;3017267;3125531;2800739;0.013563;quickSort
173900;30241210000;108364;3019267;3127631;2802539;0.013558;quickSort
174000;30276000000;108464;3021267;3129731;2804339;0.013427;quickSort
174100;30310810000;108564;3023267;3131831;2806139;0.013517;quickSort
174200;30345640000;108664;3025267;3133931;2807939;0.013825;quickSort
174300;30380490000;108764;3027267;3136031;2809739;0.013799;quickSort
174400;30415360000;108864;3029267;3138131;2811539;0.014018;quickSort
174500;30450250000;108964;3031267;3140231;2813339;0.013799;quickSort
174600;30485160000;109064;3033267;3142331;2815139;0.014008;quickSort
174700;30520090000;109164;3035267;3144431;2816939;0.013795;quickSort
174800;30555040000;109264;3037267;3146531;2818739;0.013711;quickSort
174900;30590010000;109364;3039267;3148631;2820539;0.014706;quickSort
175000;30625000000;109464;3041267;3150731;2822339;0.014302;quickSort
175100;30660010000;109564;3043267;3152831;2824139;0.014124;quickSort
175200;30695040000;109664;3045267;3154931;2825939;0.013904;quickSort
175300;30730090000;109764;3047267;3157031;2827739;0.013873;quickSort
175400;30765160000;109864;3049267;3159131;2829539;0.013903;quickSort
175500;30800250000;109964;3051267;3161231;2831339;0.013884;quickSort
175600;30835360000;110064;3053267;3163331;2833139;0.013929;quickSort
175700;30870490000;110164;3055267;3165431;2834939;0.013900;quickSort
175800;30905640000;110264;3057267;3167531;2836739;0.014078;quickSort
175900;30940810000;110364;3059267;3169631;2838539;0.013934;quickSort
176000;30976000000;110464;3061267;3171731;2840339;0.013922;quickSort
176100;31011210000;110564;3063267;3173831;2842139;0.013945;quickSort
176200;31046440000;110664;3065267;3175931;2843939;0.013924;quickSort
176300;31081690000;110764;3067267;3178031;2845739;0.013958;quickSort
176400;31116960000;110864;3069267;3180131;2847539;0.014015;quickSort
176500;31152250000;110964;3071267;3182231;2849339;0.013963;quickSort
176600;31187560000;111064;3073267;3184331;2851139;0.013988;quickSort
176700;31222890000;111164;3075267;3186431;2852939;0.013987;quickSort
176800;31258240000;111264;3077267;3188531;2854739;0.013984;quickSort
176900;31293610000;111364;3079267;3190631;2856539;0.014244;quickSort
177000;31329000000;111464;3081267;3192731;2858339;0.013999;quickSort
177100;31364410000;111564;3083267;3194831;2860139;0.014014;quickSort
177200;31399840000;111664;3085267;3196931;2861939;0.014040;quickSort
177300;31435290000;111764;3087267;3199031;2863739;0.014028;quickSort
177400;31470760000;111864;3089267;3201131;2865539;0.014029;quickSort
177500;31506250000;111964;3091267;3203231;2867339;0.014060;quickSort
177600;31541760000;112064;3093267;3205331;2869139;0.014089;quickSort
177700;31577290000;112164;3095267;3207431;2870939;0.014118;quickSort
177800;31612840000;112264;3097267;3209531;2872739;0.014086;quickSort
177900;31648410000;112364;3099267;3211631;2874539;0.014112;quickSort
178000;31684000000;112464;3101267;3213731;2876339;0.014110;quickSort
178100;31719610000;112564;3103267;3215831;2878139;0.014149;quickSort
178200;31755240000;112664;3105267;3217931;2879939;0.014516;quickSort
178300;31790890000;112764;3107267;3220031;2881739;0.014143;quickSort
178400;31826560000;112864;3109267;3222131;2883539;0.014193;quickSort
178500;31862250000;112964;3111267;3224231;2885339;0.014318;quickSort
178600;31897960000;113064;3113267;3226331;2887139;0.014160;quickSort
178700;31933690000;113164;3115267;3228431;2888939;0.014225;quickSort
178800;31969440000;113264;3117267;3230531;2890739;0.014270;quickSort
178900;32005210000;113364;3119267;3232631;2892539;0.014332;quickSort
179000;32041000000;113464;3121267;3234731;2894339;0.014180;quickSort
179100;32076810000;113564;3123267;3236831;2896139;0.014215;quickSort
179200;32112640000;113664;3125267;3238931;2897939;0.014176;quickSort
179300;32148490000;113764;3127267;3241031;2899739;0.014237;quickSort
179400;32184360000;113864;3129267;3243131;2901539;0.014176;quickSort
179500;32220250000;113964;3131267;3245231;2903339;0.014390;quickSort
179600;32256160000;114064;3133267;3247331;2905139;0.014244;quickSort
179700;32292090000;114164;3135267;3249431;2906939;0.014216;quickSort
179800;32328040000;114264;3137267;3251531;2908739;0.014236;quickSort
179900;32364010000;114364;3139267;3253631;2910539;0.014252;quickSort
180000;32400000000;114464;3141267;3255731;2912339;0.014260;quickSort
180100;32436010000;114564;3143267;3257831;2914139;0.014446;quickSort
180200;32472040000;114664;3145267;3259931;2915939;0.014817;quickSort
180300;32508090000;114764;3147267;3262031;2917739;0.014258;quickSort
180400;32544160000;114864;3149267;3264131;2919539;0.014516;quickSort
180500;32580250000;114964;3151267;3266231;2921339;0.014304;quickSort
180600;32616360000;115064;3153267;3268331;2923139;0.014586;quickSort
180700;32652490000;115164;3155267;3270431;2924939;0.014287;quickSort
180800;32688640000;115264;3157267;3272531;2926739;0.015067;quickSort
180900;32724810000;115364;3159267;3274631;2928539;0.014580;quickSort
181000;32761000000;115464;3161267;3276731;2930339;0.014567;quickSort
181100;32797210000;115564;3163267;3278831;2932139;0.014413;quickSort
181200;32833440000;115664;3165267;3280931;2933939;0.014410;quickSort
181300;32869690000;115764;3167267;3283031;2935739;0.014839;quickSort
181400;32905960000;115864;3169267;3285131;2937539;0.015610;quickSort
181500;32942250000;115964;3171267;3287231;2939339;0.014380;quickSort
181600;32978560000;116064;3173267;3289331;2941139;0.014370;quickSort
181700;33014890000;116164;3175267;3291431;2942939;0.014423;quickSort
181800;33051240000;116264;3177267;3293531;2944739;0.014432;quickSort
181900;33087610000;116364;3179267;3295631;2946539;0.014470;quickSort
182000;33124000000;116464;3181267;3297731;2948339;0.014426;quickSort
182100;33160410000;116564;3183267;3299831;2950139;0.014496;quickSort
182200;33196840000;116664;3185267;3301931;2951939;0.014476;quickSort
182300;33233290000;116764;3187267;3304031;2953739;0.014490;quickSort
182400;33269760000;116864;3189267;3306131;2955539;0.014479;quickSort
182500;33306250000;116964;3191267;3308231;2957339;0.014481;quickSort
182600;33342760000;117064;3193267;3310331;2959139;0.014556;quickSort
182700;33379290000;117164;3195267;3312431;2960939;0.014552;quickSort
182800;33415840000;117264;3197267;3314531;2962739;0.014547;quickSort
182900;33452410000;117364;3199267;3316631;2964539;0.014545;quickSort
183000;33489000000;117464;3201267;3318731;2966339;0.014553;quickSort
183100;33525610000;117564;3203267;3320831;2968139;0.014561;quickSort
183200;33562240000;117664;3205267;3322931;2969939;0.014547;quickSort
183300;33598890000;117764;3207267;3325031;2971739;0.014579;quickSort
183400;33635560000;117864;3209267;3327131;2973539;0.014621;quickSort
183500;33672250000;117964;3211267;3329231;2975339;0.014565;quickSort
183600;33708960000;118064;3213267;3331331;2977139;0.014578;quickSort
183700;33745690000;118164;3215267;3333431;2978939;0.014607;quickSort
183800;33782440000;118264;3217267;3335531;2980739;0.014646;quickSort
183900;33819210000;118364;3219267;3337631;2982539;0.015941;quickSort
184000;33856000000;118464;3221267;3339731;2984339;0.014736;quickSort
184100;33892810000;118564;3223267;3341831;2986139;0.016325;quickSort
184200;33929640000;118664;3225267;3343931;2987939;0.014790;quickSort
184300;33966490000;118764;3227267;3346031;2989739;0.014783;quickSort
184400;34003360000;118864;3229267;3348131;2991539;0.014872;quickSort
184500;34040250000;118964;3231267;3350231;2993339;0.014893;quickSort
184600;34077160000;119064;3233267;3352331;2995139;0.014799;quickSort
184700;34114090000;119164;3235267;3354431;2996939;0.015220;quickSort
184800;34151040000;119264;3237267;3356531;2998739;0.014751;quickSort
184900;34188010000;119364;3239267;3358631;3000539;0.014761;quickSort
185000;34225000000;119464;3241267;3360731;3002339;0.014744;quickSort
185100;34262010000;119564;3243267;3362831;3004139;0.014986;quickSort
185200;34299040000;119664;3245267;3364931;3005939;0.014987;quickSort
185300;34336090000;119764;3247267;3367031;3007739;0.015035;quickSort
185400;34373160000;119864;3249267;3369131;3009539;0.014964;quickSort
185500;34410250000;119964;3251267;3371231;3011339;0.014766;quickSort
185600;34447360000;120064;3253267;3373331;3013139;0.014836;quickSort
185700;34484490000;120164;3255267;3375431;3014939;0.015277;quickSort
185800;34521640000;120264;3257267;3377531;3016739;0.015367;quickSort
185900;34558810000;120364;3259267;3379631;3018539;0.014873;quickSort
186000;34596000000;120464;3261267;3381731;3020339;0.014860;quickSort
186100;34633210000;120564;3263267;3383831;3022139;0.014851;quickSort
186200;34670440000;120664;3265267;3385931;3023939;0.015017;quickSort
186300;34707690000;120764;3267267;3388031;3025739;0.014958;quickSort
186400;34744960000;120864;3269267;3390131;3027539;0.015858;quickSort
186500;34782250000;120964;3271267;3392231;3029339;0.015027;quickSort
186600;34819560000;121064;3273267;3394331;3031139;0.014855;quickSort
186700;34856890000;121164;3275267;3396431;3032939;0.014926;quickSort
186800;34894240000;121264;3277267;3398531;3034739;0.014889;quickSort
186900;34931610000;121364;3279267;3400631;3036539;0.014928;quickSort
187000;34969000000;121464;3281267;3402731;3038339;0.014915;quickSort
187100;35006410000;121564;3283267;3404831;3040139;0.015094;quickSort
187200;35043840000;121664;3285267;3406931;3041939;0.014957;quickSort
187300;35081290000;121764;3287267;3409031;3043739;0.014946;quickSort
187400;35118760000;121864;3289267;3411131;3045539;0.014949;quickSort
187500;35156250000;121964;3291267;3413231;3047339;0.015259;quickSort
187600;35193760000;122064;3293267;3415331;3049139;0.015788;quickSort
187700;35231290000;122164;3295267;3417431;3050939;0.015002;quickSort
187800;35268840000;122264;3297267;3419531;3052739;0.015065;quickSort
187900;35306410000;122364;3299267;3421631;3054539;0.015016;quickSort
188000;35344000000;122464;3301267;3423731;3056339;0.015490;quickSort
188100;35381610000;122564;3303267;3425831;3058139;0.015477;quickSort
188200;35419240000;122664;3305267;3427931;3059939;0.015509;quickSort
188300;35456890000;122764;3307267;3430031;3061739;0.015054;quickSort
188400;35494560000;122864;3309267;3432131;3063539;0.015109;quickSort
188500;35532250000;122964;3311267;3434231;3065339;0.015081;quickSort
188600;35569960000;123064;3313267;3436331;3067139;0.015064;quickSort
188700;35607690000;123164;3315267;3438431;3068939;0.015113;quickSort
188800;35645440000;123264;3317267;3440531;3070739;0.015112;quickSort
188900;35683210000;123364;3319267;3442631;3072539;0.015185;quickSort
189000;35721000000;123464;3321267;3444731;3074339;0.015177;quickSort
189100;35758810000;123564;3323267;3446831;3076139;0.016162;quickSort
189200;35796640000;123664;3325267;3448931;3077939;0.015152;quickSort
189300;35834490000;123764;3327267;3451031;3079739;0.015130;quickSort
189400;35872360000;123864;3329267;3453131;3081539;0.015161;quickSort
189500;35910250000;123964;3331267;3455231;3083339;0.015120;quickSort
189600;35948160000;124064;3333267;3457331;3085139;0.015177;quickSort
189700;35986090000;124164;3335267;3459431;3086939;0.015153;quickSort
189800;36024040000;124264;3337267;3461531;3088739;0.015354;quickSort
189900;36062010000;124364;3339267;3463631;3090539;0.015200;quickSort
190000;36100000000;124464;3341267;3465731;3092339;0.015949;quickSort
190100;36138010000;124564;3343267;3467831;3094139;0.015206;quickSort
190200;36176040000;124664;3345267;3469931;3095939;0.014915;quickSort
190300;36214090000;124764;3347267;3472031;3097739;0.015233;quickSort
190400;36252160000;124864;3349267;3474131;3099539;0.015280;quickSort
190500;36290250000;124964;3351267;3476231;3101339;0.015280;quickSort
190600;36328360000;125064;3353267;3478331;3103139;0.015258;quickSort
190700;36366490000;125164;3355267;3480431;3104939;0.015302;quickSort
190800;36404640000;125264;3357267;3482531;3106739;0.015277;quickSort
190900;36442810000;125364;3359267;3484631;3108539;0.015323;quickSort
191000;36481000000;125464;3361267;3486731;3110339;0.014896;quickSort
191100;36519210000;125564;3363267;3488831;3112139;0.015366;quickSort
191200;36557440000;125664;3365267;3490931;3113939;0.016071;quickSort
191300;36595690000;125764;3367267;3493031;3115739;0.015406;quickSort
191400;36633960000;125864;3369267;3495131;3117539;0.015389;quickSort
191500;36672250000;125964;3371267;3497231;3119339;0.015413;quickSort
191600;36710560000;126064;3373267;3499331;3121139;0.015087;quickSort
191700;36748890000;126164;3375267;3501431;3122939;0.014955;quickSort
191800;36787240000;126264;3377267;3503531;3124739;0.015356;quickSort
191900;36825610000;126364;3379267;3505631;3126539;0.015364;quickSort
192000;36864000000;126464;3381267;3507731;3128339;0.015404;quickSort
192100;36902410000;126564;3383267;3509831;3130139;0.015451;quickSort
192200;36940840000;126664;3385267;3511931;3131939;0.015431;quickSort
192300;36979290000;126764;3387267;3514031;3133739;0.015484;quickSort
192400;37017760000;126864;3389267;3516131;3135539;0.015445;quickSort
192500;37056250000;126964;3391267;3518231;3137339;0.015459;quickSort
192600;37094760000;127064;3393267;3520331;3139139;0.015523;quickSort
192700;37133290000;127164;3395267;3522431;3140939;0.015470;quickSort
192800;37171840000;127264;3397267;3524531;3142739;0.015470;quickSort
192900;37210410000;127364;3399267;3526631;3144539;0.015467;quickSort
193000;37249000000;127464;3401267;3528731;3146339;0.015501;quickSort
193100;37287610000;127564;3403267;3530831;3148139;0.015475;quickSort
193200;37326240000;127664;3405267;3532931;3149939;0.015516;quickSort
193300;37364890000;127764;3407267;3535031;3151739;0.015531;quickSort
193400;37403560000;127864;3409267;3537131;3153539;0.015893;quickSort
193500;37442250000;127964;3411267;3539231;3155339;0.015521;quickSort
193600;37480960000;128064;3413267;3541331;3157139;0.015779;quickSort
193700;37519690000;128164;3415267;3543431;3158939;0.015807;quickSort
193800;37558440000;128264;3417267;3545531;3160739;0.015990;quickSort
193900;37597210000;128364;3419267;3547631;3162539;0.015578;quickSort
194000;37636000000;128464;3421267;3549731;3164339;0.015592;quickSort
194100;37674810000;128564;3423267;3551831;3166139;0.015610;quickSort
194200;37713640000;128664;3425267;3553931;3167939;0.017033;quickSort
194300;37752490000;128764;3427267;3556031;3169739;0.015621;quickSort
194400;37791360000;128864;3429267;3558131;3171539;0.015633;quickSort
194500;37830250000;128964;3431267;3560231;3173339;0.015617;quickSort
194600;37869160000;129064;3433267;3562331;3175139;0.015621;quickSort
194700;37908090000;129164;3435267;3564431;3176939;0.015645;quickSort
194800;37947040000;129264;3437267;3566531;3178739;0.015689;quickSort
194900;37986010000;129364;3439267;3568631;3180539;0.015745;quickSort
195000;38025000000;129464;3441267;3570731;3182339;0.015699;quickSort
195100;38064010000;129564;3443267;3572831;3184139;0.015678;quickSort
195200;38103040000;129664;3445267;3574931;3185939;0.015695;quickSort
195300;38142090000;129764;3447267;3577031;3187739;0.015698;quickSort
195400;38181160000;129864;3449267;3579131;3189539;0.015702;quickSort
195500;38220250000;129964;3451267;3581231;3191339;0.015728;quickSort
195600;38259360000;130064;3453267;3583331;3193139;0.015707;quickSort
195700;38298490000;130164;3455267;3585431;3194939;0.015750;quickSort
195800;38337640000;130264;3457267;3587531;3196739;0.015747;quickSort
195900;38376810000;130364;3459267;3589631;3198539;0.017440;quickSort
196000;38416000000;130464;3461267;3591731;3200339;0.015854;quickSort
196100;38455210000;130564;3463267;3593831;3202139;0.016248;quickSort
196200;38494440000;130664;3465267;3595931;3203939;0.015825;quickSort
196300;38533690000;130764;3467267;3598031;3205739;0.015837;quickSort
196400;38572960000;130864;3469267;3600131;3207539;0.016002;quickSort
196500;38612250000;130964;3471267;3602231;3209339;0.015838;quickSort
196600;38651560000;131064;3473267;3604331;3211139;0.015845;quickSort
196700;38690890000;131071;3474988;3606059;3212846;0.015854;quickSort
196800;38730240000;131071;3476688;3607759;3214546;0.015835;quickSort
196900;38769610000;131071;3478388;3609459;3216246;0.015858;quickSort
197000;38809000000;131071;3480088;3611159;3217946;0.015909;quickSort
197100;38848410000;131071;3481788;3612859;3219646;0.015923;quickSort
197200;38887840000;131071;3483488;3614559;3221346;0.016117;quickSort
197300;38927290000;131071;3485188;3616259;3223046;0.016432;quickSort
197400;38966760000;131071;3486888;3617959;3224746;0.015890;quickSort
197500;39006250000;131071;3488588;3619659;3226446;0.015878;quickSort
197600;39045760000;131071;3490288;3621359;3228146;0.015937;quickSort
197700;39085290000;131071;3491988;3623059;3229846;0.016115;quickSort
197800;39124840000;131071;3493688;3624759;3231546;0.016029;quickSort
197900;39164410000;131071;3495388;3626459;3233246;0.015929;quickSort
198000;39204000000;131071;3497088;3628159;3234946;0.016016;quickSort
198100;39243610000;131071;3498788;3629859;3236646;0.015973;quickSort
198200;39283240000;131071;3500488;3631559;3238346;0.016453;quickSort
198300;39322890000;131071;3502188;3633259;3240046;0.015973;quickSort
198400;39362560000;131071;3503888;3634959;3241746;0.016102;quickSort
198500;39402250000;131071;3505588;3636659;3243446;0.016013;quickSort
198600;39441960000;131071;3507288;3638359;3245146;0.016019;quickSort
198700;39481690000;131071;3508988;3640059;3246846;0.016003;quickSort
198800;39521440000;131071;3510688;3641759;3248546;0.016184;quickSort
198900;39561210000;131071;3512388;3643459;3250246;0.016046;quickSort
199000;39601000000;131071;3514088;3645159;3251946;0.016063;quickSort
199100;39640810000;131071;3515788;3646859;3253646;0.016071;quickSort
199200;39680640000;131071;3517488;3648559;3255346;0.016344;quickSort
199300;39720490000;131071;3519188;3650259;3257046;0.015756;quickSort
199400;39760360000;131071;3520888;3651959;3258746;0.015716;quickSort
199500;39800250000;131071;3522588;3653659;3260446;0.016294;quickSort
199600;39840160000;131071;3524288;3655359;3262146;0.016204;quickSort
199700;39880090000;131071;3525988;3657059;3263846;0.016112;quickSort
199800;39920040000;131071;3527688;3658759;3265546;0.016291;quickSort
199900;39960010000;131071;3529388;3660459;3267246;0.016144;quickSort
200000;40000000000;131071;3531088;3662159;3268946;0.017269;quickSort
200100;40040010000;131071;3532788;3663859;3270646;0.016431;quickSort
200200;40080040000;131071;3534488;3665559;3272346;0.016156;quickSort
200300;40120090000;131071;3536188;3667259;3274046;0.016186;quickSort
200400;40160160000;131071;3537888;3668959;3275746;0.016185;quickSort
200500;40200250000;131071;3539588;3670659;3277446;0.015779;quickSort
200600;40240360000;131071;3541288;3672359;3279146;0.015764;quickSort
200700;40280490000;131071;3542988;3674059;3280846;0.015783;quickSort
200800;40320640000;131071;3544688;3675759;3282546;0.016375;quickSort
200900;40360810000;131071;3546388;3677459;3284246;0.016240;quickSort
201000;40401000000;131071;3548088;3679159;3285946;0.016230;quickSort
201100;40441210000;131071;3549788;3680859;3287646;0.016213;quickSort
201200;40481440000;131071;3551488;3682559;3289346;0.016236;quickSort
201300;40521690000;131071;3553188;3684259;3291046;0.016439;quickSort
201400;40561960000;131071;3554888;3685959;3292746;0.016225;quickSort
201500;40602250000;131071;3556588;3687659;3294446;0.016301;quickSort
201600;40642560000;131071;3558288;3689359;3296146;0.016259;quickSort
201700;40682890000;131071;3559988;3691059;3297846;0.016280;quickSort
201800;40723240000;131071;3561688;3692759;3299546;0.016271;quickSort
201900;40763610000;131071;3563388;3694459;3301246;0.015887;quickSort
202000;40804000000;131071;3565088;3696159;3302946;0.015932;quickSort
202100;40844410000;131071;3566788;3697859;3304646;0.016721;quickSort
202200;40884840000;131071;3568488;3699559;3306346;0.016372;quickSort
202300;40925290000;131071;3570188;3701259;3308046;0.016457;quickSort
202400;40965760000;131071;3571888;3702959;3309746;0.018229;quickSort
202500;41006250000;131071;3573588;3704659;3311446;0.016374;quickSort
202600;41046760000;131071;3575288;3706359;3313146;0.017718;quickSort
202700;41087290000;131071;3576988;3708059;3314846;0.016357;quickSort
202800;41127840000;131071;3578688;3709759;3316546;0.016401;quickSort
202900;41168410000;131071;3580388;3711459;3318246;0.016401;quickSort
203000;41209000000;131071;3582088;3713159;3319946;0.017682;quickSort
203100;41249610000;131071;3583788;3714859;3321646;0.016772;quickSort
203200;41290240000;131071;3585488;3716559;3323346;0.016457;quickSort
203300;41330890000;131071;3587188;3718259;3325046;0.016639;quickSort
203400;41371560000;131071;3588888;3719959;3326746;0.017126;quickSort
203500;41412250000;131071;3590588;3721659;3328446;0.016683;quickSort
203600;41452960000;131071;3592288;3723359;3330146;0.016515;quickSort
203700;41493690000;131071;3593988;3725059;3331846;0.017255;quickSort
203800;41534440000;131071;3595688;3726759;3333546;0.016450;quickSort
203900;41575210000;131071;3597388;3728459;3335246;0.016462;quickSort
204000;41616000000;131071;3599088;3730159;3336946;0.016486;quickSort
204100;41656810000;131071;3600788;3731859;3338646;0.016528;quickSort
204200;41697640000;131071;3602488;3733559;3340346;0.016596;quickSort
204300;41738490000;131071;3604188;3735259;3342046;0.016612;quickSort
204400;41779360000;131071;3605888;3736959;3343746;0.016482;quickSort
204500;41820250000;131071;3607588;3738659;3345446;0.016532;quickSort
204600;41861160000;131071;3609288;3740359;3347146;0.016574;quickSort
204700;41902090000;131071;3610988;3742059;3348846;0.016914;quickSort
204800;41943040000;131071;3612688;3743759;3350546;0.016552;quickSort
204900;41984010000;131071;3614388;3745459;3352246;0.016514;quickSort
205000;42025000000;131071;3616088;3747159;3353946;0.016573;quickSort
205100;42066010000;131071;3617788;3748859;3355646;0.016575;quickSort
205200;42107040000;131071;3619488;3750559;3357346;0.016602;quickSort
205300;42148090000;131071;3621188;3752259;3359046;0.016629;quickSort
205400;42189160000;131071;3622888;3753959;3360746;0.017171;quickSort
205500;42230250000;131071;3624588;3755659;3362446;0.016570;quickSort
205600;42271360000;131071;3626288;3757359;3364146;0.016573;quickSort
205700;42312490000;131071;3627988;3759059;3365846;0.016612;quickSort
205800;42353640000;131071;3629688;3760759;3367546;0.016668;quickSort
205900;42394810000;131071;3631388;3762459;3369246;0.016591;quickSort
206000;42436000000;131071;3633088;3764159;3370946;0.016603;quickSort
206100;42477210000;131071;3634788;3765859;3372646;0.016670;quickSort
206200;42518440000;131071;3636488;3767559;3374346;0.016621;quickSort
206300;42559690000;131071;3638188;3769259;3376046;0.016679;quickSort
206400;42600960000;131071;3639888;3770959;3377746;0.016691;quickSort
206500;42642250000;131071;3641588;3772659;3379446;0.016842;quickSort
206600;42683560000;131071;3643288;3774359;3381146;0.016662;quickSort
206700;42724890000;131071;3644988;3776059;3382846;0.016671;quickSort
206800;42766240000;131071;3646688;3777759;3384546;0.016702;quickSort
206900;42807610000;131071;3648388;3779459;3386246;0.016723;quickSort
207000;42849000000;131071;3650088;3781159;3387946;0.016699;quickSort
207100;42890410000;131071;3651788;3782859;3389646;0.017165;quickSort
207200;42931840000;131071;3653488;3784559;3391346;0.016682;quickSort
207300;42973290000;131071;3655188;3786259;3393046;0.016704;quickSort
207400;43014760000;131071;3656888;3787959;3394746;0.016744;quickSort
207500;43056250000;131071;3658588;3789659;3396446;0.016745;quickSort
207600;43097760000;131071;3660288;3791359;3398146;0.016994;quickSort
207700;43139290000;131071;3661988;3793059;3399846;0.016803;quickSort
207800;43180840000;131071;3663688;3794759;3401546;0.016849;quickSort
207900;43222410000;131071;3665388;3796459;3403246;0.016850;quickSort
208000;43264000000;131071;3667088;3798159;3404946;0.016797;quickSort
208100;43305610000;131071;3668788;3799859;3406646;0.019214;quickSort
208200;43347240000;131071;3670488;3801559;3408346;0.016754;quickSort
208300;43388890000;131071;3672188;3803259;3410046;0.016777;quickSort
208400;43430560000;131071;3673888;3804959;3411746;0.016804;quickSort
208500;43472250000;131071;3675588;3806659;3413446;0.017460;quickSort
208600;43513960000;131071;3677288;3808359;3415146;0.016812;quickSort
208700;43555690000;131071;3678988;3810059;3416846;0.016864;quickSort
208800;43597440000;131071;3680688;3811759;3418546;0.017058;quickSort
208900;43639210000;131071;3682388;3813459;3420246;0.016888;quickSort
209000;43681000000;131071;3684088;3815159;3421946;0.016860;quickSort
209100;43722810000;131071;3685788;3816859;3423646;0.016980;quickSort
209200;43764640000;131071;3687488;3818559;3425346;0.016894;quickSort
209300;43806490000;131071;3689188;3820259;3427046;0.016873;quickSort
209400;43848360000;131071;3690888;3821959;3428746;0.016891;quickSort
209500;43890250000;131071;3692588;3823659;3430446;0.016896;quickSort
209600;43932160000;131071;3694288;3825359;3432146;0.016885;quickSort
209700;43974090000;131071;3695988;3827059;3433846;0.016870;quickSort
209800;44016040000;131071;3697688;3828759;3435546;0.016889;quickSort
209900;44058010000;131071;3699388;3830459;3437246;0.016992;quickSort
210000;44100000000;131071;3701088;3832159;3438946;0.017493;quickSort
210100;44142010000;131071;3702788;3833859;3440646;0.016982;quickSort
210200;44184040000;131071;3704488;3835559;3442346;0.016952;quickSort
210300;44226090000;131071;3706188;3837259;3444046;0.017347;quickSort
210400;44268160000;131071;3707888;3838959;3445746;0.016972;quickSort
210500;44310250000;131071;3709588;3840659;3447446;0.022413;quickSort
210600;44352360000;131071;3711288;3842359;3449146;0.023174;quickSort
210700;44394490000;131071;3712988;3844059;3450846;0.019537;quickSort
210800;44436640000;131071;3714688;3845759;3452546;0.017036;quickSort
210900;44478810000;131071;3716388;3847459;3454246;0.017152;quickSort
211000;44521000000;131071;3718088;3849159;3455946;0.018162;quickSort
211100;44563210000;131071;3719788;3850859;3457646;0.016967;quickSort
211200;44605440000;131071;3721488;3852559;3459346;0.017032;quickSort
211300;44647690000;131071;3723188;3854259;3461046;0.016928;quickSort
211400;44689960000;131071;3724888;3855959;3462746;0.017348;quickSort
211500;44732250000;131071;3726588;3857659;3464446;0.017028;quickSort
211600;44774560000;131071;3728288;3859359;3466146;0.016986;quickSort
211700;44816890000;131071;3729988;3861059;3467846;0.017105;quickSort
211800;44859240000;131071;3731688;3862759;3469546;0.017048;quickSort
211900;44901610000;131071;3733388;3864459;3471246;0.017067;quickSort
212000;44944000000;131071;3735088;3866159;3472946;0.036869;quickSort
212100;44986410000;131071;3736788;3867859;3474646;0.035950;quickSort
212200;45028840000;131071;3738488;3869559;3476346;0.035294;quickSort
212300;45071290000;131071;3740188;3871259;3478046;0.035464;quickSort
212400;45113760000;131071;3741888;3872959;3479746;0.018156;quickSort
212500;45156250000;131071;3743588;3874659;3481446;0.020118;quickSort
212600;45198760000;131071;3745288;3876359;3483146;0.018832;quickSort
212700;45241290000;131071;3746988;3878059;3484846;0.018868;quickSort
212800;45283840000;131071;3748688;3879759;3486546;0.016669;quickSort
212900;45326410000;131071;3750388;3881459;3488246;0.017049;quickSort
213000;45369000000;131071;3752088;3883159;3489946;0.017086;quickSort
213100;45411610000;131071;3753788;3884859;3491646;0.017086;quickSort
213200;45454240000;131071;3755488;3886559;3493346;0.017819;quickSort
213300;45496890000;131071;3757188;3888259;3495046;0.017128;quickSort
213400;45539560000;131071;3758888;3889959;3496746;0.017093;quickSort
213500;45582250000;131071;3760588;3891659;3498446;0.017071;quickSort
213600;45624960000;131071;3762288;3893359;3500146;0.017154;quickSort
213700;45667690000;131071;3763988;3895059;3501846;0.017194;quickSort
213800;45710440000;131071;3765688;3896759;3503546;0.017465;quickSort
213900;45753210000;131071;3767388;3898459;3505246;0.017622;quickSort
214000;45796000000;131071;3769088;3900159;3506946;0.017726;quickSort
214100;45838810000;131071;3770788;3901859;3508646;0.017141;quickSort
214200;45881640000;131071;3772488;3903559;3510346;0.017158;quickSort
214300;45924490000;131071;3774188;3905259;3512046;0.017145;quickSort
214400;45967360000;131071;3775888;3906959;3513746;0.017201;quickSort
214500;46010250000;131071;3777588;3908659;3515446;0.017137;quickSort
214600;46053160000;131071;3779288;3910359;3517146;0.016765;quickSort
214700;46096090000;131071;3780988;3912059;3518846;0.016745;quickSort
214800;46139040000;131071;3782688;3913759;3520546;0.017176;quickSort
214900;46182010000;131071;3784388;3915459;3522246;0.017348;quickSort
215000;46225000000;131071;3786088;3917159;3523946;0.017812;quickSort
215100;46268010000;131071;3787788;3918859;3525646;0.017214;quickSort
215200;46311040000;131071;3789488;3920559;3527346;0.017165;quickSort
215300;46354090000;131071;3791188;3922259;3529046;0.017208;quickSort
215400;46397160000;131071;3792888;3923959;3530746;0.017216;quickSort
215500;46440250000;131071;3794588;3925659;3532446;0.017260;quickSort
215600;46483360000;131071;3796288;3927359;3534146;0.017477;quickSort
215700;46526490000;131071;3797988;3929059;3535846;0.017235;quickSort
215800;46569640000;131071;3799688;3930759;3537546;0.017261;quickSort
215900;46612810000;131071;3801388;3932459;3539246;0.017268;quickSort
216000;46656000000;131071;3803088;3934159;3540946;0.017591;quickSort
216100;46699210000;131071;3804788;3935859;3542646;0.017395;quickSort
216200;46742440000;131071;3806488;3937559;3544346;0.018309;quickSort
216300;46785690000;131071;3808188;3939259;3546046;0.017341;quickSort
216400;46828960000;131071;3809888;3940959;3547746;0.017405;quickSort
216500;46872250000;131071;3811588;3942659;3549446;0.017328;quickSort
216600;46915560000;131071;3813288;3944359;3551146;0.017700;quickSort
216700;46958890000;131071;3814988;3946059;3552846;0.017698;quickSort
216800;47002240000;131071;3816688;3947759;3554546;0.017294;quickSort
216900;47045610000;131071;3818388;3949459;3556246;0.017313;quickSort
217000;47089000000;131071;3820088;3951159;3557946;0.017376;quickSort
217100;47132410000;131071;3821788;3952859;3559646;0.017336;quickSort
217200;47175840000;131071;3823488;3954559;3561346;0.017374;quickSort
217300;47219290000;131071;3825188;3956259;3563046;0.017317;quickSort
217400;47262760000;131071;3826888;3957959;3564746;0.017377;quickSort
217500;47306250000;131071;3828588;3959659;3566446;0.017316;quickSort
217600;47349760000;131071;3830288;3961359;3568146;0.017386;quickSort
217700;47393290000;131071;3831988;3963059;3569846;0.017626;quickSort
217800;47436840000;131071;3833688;3964759;3571546;0.017322;quickSort
217900;47480410000;131071;3835388;3966459;3573246;0.017600;quickSort
218000;47524000000;131071;3837088;3968159;3574946;0.017357;quickSort
218100;47567610000;131071;3838788;3969859;3576646;0.017669;quickSort
218200;47611240000;131071;3840488;3971559;3578346;0.017446;quickSort
218300;47654890000;131071;3842188;3973259;3580046;0.017700;quickSort
218400;47698560000;131071;3843888;3974959;3581746;0.017465;quickSort
218500;47742250000;131071;3845588;3976659;3583446;0.017416;quickSort
218600;47785960000;131071;3847288;3978359;3585146;0.017772;quickSort
218700;47829690000;131071;3848988;3980059;3586846;0.017480;quickSort
218800;47873440000;131071;3850688;3981759;3588546;0.017477;quickSort
218900;47917210000;131071;3852388;3983459;3590246;0.017916;quickSort
219000;47961000000;131071;3854088;3985159;3591946;0.017540;quickSort
219100;48004810000;131071;3855788;3986859;3593646;0.017919;quickSort
219200;48048640000;131071;3857488;3988559;3595346;0.017732;quickSort
219300;48092490000;131071;3859188;3990259;3597046;0.017606;quickSort
219400;48136360000;131071;3860888;3991959;3598746;0.017461;quickSort
219500;48180250000;131071;3862588;3993659;3600446;0.017453;quickSort
219600;48224160000;131071;3864288;3995359;3602146;0.018321;quickSort
219700;48268090000;131071;3865988;3997059;3603846;0.017685;quickSort
219800;48312040000;131071;3867688;3998759;3605546;0.017713;quickSort
219900;48356010000;131071;3869388;4000459;3607246;0.017660;quickSort
220000;48400000000;131071;3871088;4002159;3608946;0.018633;quickSort
220100;48444010000;131071;3872788;4003859;3610646;0.017519;quickSort
220200;48488040000;131071;3874488;4005559;3612346;0.017712;quickSort
220300;48532090000;131071;3876188;4007259;3614046;0.017514;quickSort
220400;48576160000;131071;3877888;4008959;3615746;0.017778;quickSort
220500;48620250000;131071;3879588;4010659;3617446;0.017554;quickSort
220600;48664360000;131071;3881288;4012359;3619146;0.018877;quickSort
220700;48708490000;131071;3882988;4014059;3620846;0.017619;quickSort
220800;48752640000;131071;3884688;4015759;3622546;0.017630;quickSort
220900;48796810000;131071;3886388;4017459;3624246;0.017610;quickSort
221000;48841000000;131071;3888088;4019159;3625946;0.017622;quickSort
221100;48885210000;131071;3889788;4020859;3627646;0.017815;quickSort
221200;48929440000;131071;3891488;4022559;3629346;0.017549;quickSort
221300;48973690000;131071;3893188;4024259;3631046;0.017585;quickSort
221400;49017960000;131071;3894888;4025959;3632746;0.017577;quickSort
221500;49062250000;131071;3896588;4027659;3634446;0.017569;quickSort
221600;49106560000;131071;3898288;4029359;3636146;0.017619;quickSort
221700;49150890000;131071;3899988;4031059;3637846;0.017587;quickSort
221800;49195240000;131071;3901688;4032759;3639546;0.017609;quickSort
221900;49239610000;131071;3903388;4034459;3641246;0.018014;quickSort
222000;49284000000;131071;3905088;4036159;3642946;0.017621;quickSort
222100;49328410000;131071;3906788;4037859;3644646;0.017608;quickSort
222200;49372840000;131071;3908488;4039559;3646346;0.017632;quickSort
222300;49417290000;131071;3910188;4041259;3648046;0.017645;quickSort
222400;49461760000;131071;3911888;4042959;3649746;0.018978;quickSort
222500;49506250000;131071;3913588;4044659;3651446;0.017737;quickSort
222600;49550760000;131071;3915288;4046359;3653146;0.017628;quickSort
222700;49595290000;131071;3916988;4048059;3654846;0.017369;quickSort
222800;49639840000;131071;3918688;4049759;3656546;0.017171;quickSort
222900;49684410000;131071;3920388;4051459;3658246;0.017202;quickSort
223000;49729000000;131071;3922088;4053159;3659946;0.017692;quickSort
223100;49773610000;131071;3923788;4054859;3661646;0.017633;quickSort
223200;49818240000;131071;3925488;4056559;3663346;0.017699;quickSort
223300;49862890000;131071;3927188;4058259;3665046;0.018045;quickSort
223400;49907560000;131071;3928888;4059959;3666746;0.017840;quickSort
223500;49952250000;131071;3930588;4061659;3668446;0.018122;quickSort
223600;49996960000;131071;3932288;4063359;3670146;0.017637;quickSort
223700;50041690000;131071;3933988;4065059;3671846;0.018084;quickSort
223800;50086440000;131071;3935688;4066759;3673546;0.017721;quickSort
223900;50131210000;131071;3937388;4068459;3675246;0.017695;quickSort
224000;50176000000;131071;3939088;4070159;3676946;0.017705;quickSort
224100;50220810000;131071;3940788;4071859;3678646;0.017693;quickSort
224200;50265640000;131071;3942488;4073559;3680346;0.017838;quickSort
224300;50310490000;131071;3944188;4075259;3682046;0.017707;quickSort
224400;50355360000;131071;3945888;4076959;3683746;0.018058;quickSort
224500;50400250000;131071;3947588;4078659;3685446;0.017744;quickSort
224600;50445160000;131071;3949288;4080359;3687146;0.017747;quickSort
224700;50490090000;131071;3950988;4082059;3688846;0.017915;quickSort
224800;50535040000;131071;3952688;4083759;3690546;0.017733;quickSort
224900;50580010000;131071;3954388;4085459;3692246;0.017753;quickSort
225000;50625000000;131071;3956088;4087159;3693946;0.017738;quickSort
225100;50670010000;131071;3957788;4088859;3695646;0.017806;quickSort
225200;50715040000;131071;3959488;4090559;3697346;0.017771;quickSort
225300;50760090000;131071;3961188;4092259;3699046;0.017769;quickSort
225400;50805160000;131071;3962888;4093959;3700746;0.017708;quickSort
225500;50850250000;131071;3964588;4095659;3702446;0.018089;quickSort
225600;50895360000;131071;3966288;4097359;3704146;0.017325;quickSort
225700;50940490000;131071;3967988;4099059;3705846;0.017430;quickSort
225800;50985640000;131071;3969688;4100759;3707546;0.017644;quickSort
225900;51030810000;131071;3971388;4102459;3709246;0.017303;quickSort
226000;51076000000;131071;3973088;4104159;3710946;0.017351;quickSort
226100;51121210000;131071;3974788;4105859;3712646;0.017484;quickSort
226200;51166440000;131071;3976488;4107559;3714346;0.017785;quickSort
226300;51211690000;131071;3978188;4109259;3716046;0.017756;quickSort
226400;51256960000;131071;3979888;4110959;3717746;0.017798;quickSort
226500;51302250000;131071;3981588;4112659;3719446;0.017769;quickSort
226600;51347560000;131071;3983288;4114359;3721146;0.018124;quickSort
226700;51392890000;131071;3984988;4116059;3722846;0.018176;quickSort
226800;51438240000;131071;3986688;4117759;3724546;0.017796;quickSort
226900;51483610000;131071;3988388;4119459;3726246;0.017862;quickSort
227000;51529000000;131071;3990088;4121159;3727946;0.017778;quickSort
227100;51574410000;131071;3991788;4122859;3729646;0.019888;quickSort
227200;51619840000;131071;3993488;4124559;3731346;0.017869;quickSort
227300;51665290000;131071;3995188;4126259;3733046;0.017900;quickSort
227400;51710760000;131071;3996888;4127959;3734746;0.017931;quickSort
227500;51756250000;131071;3998588;4129659;3736446;0.017994;quickSort
227600;51801760000;131071;4000288;4131359;3738146;0.018051;quickSort
227700;51847290000;131071;4001988;4133059;3739846;0.017826;quickSort
227800;51892840000;131071;4003688;4134759;3741546;0.018026;quickSort
227900;51938410000;131071;4005388;4136459;3743246;0.017774;quickSort
228000;51984000000;131071;4007088;4138159;3744946;0.017871;quickSort
228100;52029610000;131071;4008788;4139859;3746646;0.018049;quickSort
228200;52075240000;131071;4010488;4141559;3748346;0.017951;quickSort
228300;52120890000;131071;4012188;4143259;3750046;0.017885;quickSort
228400;52166560000;131071;4013888;4144959;3751746;0.017924;quickSort
228500;52212250000;131071;4015588;4146659;3753446;0.017975;quickSort
228600;52257960000;131071;4017288;4148359;3755146;0.017990;quickSort
228700;52303690000;131071;4018988;4150059;3756846;0.017915;quickSort
228800;52349440000;131071;4020688;4151759;3758546;0.017897;quickSort
228900;52395210000;131071;4022388;4153459;3760246;0.017966;quickSort
229000;52441000000;131071;4024088;4155159;3761946;0.018186;quickSort
229100;52486810000;131071;4025788;4156859;3763646;0.018935;quickSort
229200;52532640000;131071;4027488;4158559;3765346;0.017672;quickSort
229300;52578490000;131071;4029188;4160259;3767046;0.017980;quickSort
229400;52624360000;131071;4030888;4161959;3768746;0.018713;quickSort
229500;52670250000;131071;4032588;4163659;3770446;0.018860;quickSort
229600;52716160000;131071;4034288;4165359;3772146;0.018348;quickSort
229700;52762090000;131071;4035988;4167059;3773846;0.018307;quickSort
229800;52808040000;131071;4037688;4168759;3775546;0.018001;quickSort
229900;52854010000;131071;4039388;4170459;3777246;0.018003;quickSort
230000;52900000000;131071;4041088;4172159;3778946;0.017954;quickSort
230100;52946010000;131071;4042788;4173859;3780646;0.017967;quickSort
230200;52992040000;131071;4044488;4175559;3782346;0.018096;quickSort
230300;53038090000;131071;4046188;4177259;3784046;0.018011;quickSort
230400;53084160000;131071;4047888;4178959;3785746;0.017987;quickSort
230500;53130250000;131071;4049588;4180659;3787446;0.017670;quickSort
230600;53176360000;131071;4051288;4182359;3789146;0.017713;quickSort
230700;53222490000;131071;4052988;4184059;3790846;0.018031;quickSort
230800;53268640000;131071;4054688;4185759;3792546;0.018069;quickSort
230900;53314810000;131071;4056388;4187459;3794246;0.018053;quickSort
231000;53361000000;131071;4058088;4189159;3795946;0.018116;quickSort
231100;53407210000;131071;4059788;4190859;3797646;0.018127;quickSort
231200;53453440000;131071;4061488;4192559;3799346;0.018064;quickSort
231300;53499690000;131071;4063188;4194259;3801046;0.018048;quickSort
231400;53545960000;131071;4064888;4195959;3802746;0.018090;quickSort
231500;53592250000;131071;4066588;4197659;3804446;0.018074;quickSort
231600;53638560000;131071;4068288;4199359;3806146;0.018062;quickSort
231700;53684890000;131071;4069988;4201059;3807846;0.018117;quickSort
231800;53731240000;131071;4071688;4202759;3809546;0.018088;quickSort
231900;53777610000;131071;4073388;4204459;3811246;0.018101;quickSort
232000;53824000000;131071;4075088;4206159;3812946;0.018095;quickSort
232100;53870410000;131071;4076788;4207859;3814646;0.017772;quickSort
232200;53916840000;131071;4078488;4209559;3816346;0.018511;quickSort
232300;53963290000;131071;4080188;4211259;3818046;0.018182;quickSort
232400;54009760000;131071;4081888;4212959;3819746;0.018110;quickSort
232500;54056250000;131071;4083588;4214659;3821446;0.018298;quickSort
232600;54102760000;131071;4085288;4216359;3823146;0.018151;quickSort
232700;54149290000;131071;4086988;4218059;3824846;0.017930;quickSort
232800;54195840000;131071;4088688;4219759;3826546;0.017769;quickSort
232900;54242410000;131071;4090388;4221459;3828246;0.017765;quickSort
233000;54289000000;131071;4092088;4223159;3829946;0.018227;quickSort
233100;54335610000;131071;4093788;4224859;3831646;0.018235;quickSort
233200;54382240000;131071;4095488;4226559;3833346;0.019764;quickSort
233300;54428890000;131071;4097188;4228259;3835046;0.018297;quickSort
233400;54475560000;131071;4098888;4229959;3836746;0.019027;quickSort
233500;54522250000;131071;4100588;4231659;3838446;0.018336;quickSort
233600;54568960000;131071;4102288;4233359;3840146;0.018215;quickSort
233700;54615690000;131071;4103988;4235059;3841846;0.018359;quickSort
233800;54662440000;131071;4105688;4236759;3843546;0.018263;quickSort
233900;54709210000;131071;4107388;4238459;3845246;0.018253;quickSort
234000;54756000000;131071;4109088;4240159;3846946;0.019514;quickSort
234100;54802810000;131071;4110788;4241859;3848646;0.018279;quickSort
234200;54849640000;131071;4112488;4243559;3850346;0.018446;quickSort
234300;54896490000;131071;4114188;4245259;3852046;0.018374;quickSort
234400;54943360000;131071;4115888;4246959;3853746;0.018696;quickSort
234500;54990250000;131071;4117588;4248659;3855446;0.018410;quickSort
234600;55037160000;131071;4119288;4250359;3857146;0.018328;quickSort
234700;55084090000;131071;4120988;4252059;3858846;0.019230;quickSort
234800;55131040000;131071;4122688;4253759;3860546;0.019085;quickSort
234900;55178010000;131071;4124388;4255459;3862246;0.017954;quickSort
235000;55225000000;131071;4126088;4257159;3863946;0.018432;quickSort
235100;55272010000;131071;4127788;4258859;3865646;0.018403;quickSort
235200;55319040000;131071;4129488;4260559;3867346;0.018382;quickSort
235300;55366090000;131071;4131188;4262259;3869046;0.018419;quickSort
235400;55413160000;131071;4132888;4263959;3870746;0.018358;quickSort
235500;55460250000;131071;4134588;4265659;3872446;0.018368;quickSort
235600;55507360000;131071;4136288;4267359;3874146;0.018401;quickSort
235700;55554490000;131071;4137988;4269059;3875846;0.018944;quickSort
235800;55601640000;131071;4139688;4270759;3877546;0.018534;quickSort
235900;55648810000;131071;4141388;4272459;3879246;0.018877;quickSort
236000;55696000000;131071;4143088;4274159;3880946;0.018457;quickSort
236100;55743210000;131071;4144788;4275859;3882646;0.018438;quickSort
236200;55790440000;131071;4146488;4277559;3884346;0.018451;quickSort
236300;55837690000;131071;4148188;4279259;3886046;0.018469;quickSort
236400;55884960000;131071;4149888;4280959;3887746;0.018433;quickSort
236500;55932250000;131071;4151588;4282659;3889446;0.018878;quickSort
236600;55979560000;131071;4153288;4284359;3891146;0.018465;quickSort
236700;56026890000;131071;4154988;4286059;3892846;0.018519;quickSort
236800;56074240000;131071;4156688;4287759;3894546;0.018476;quickSort
236900;56121610000;131071;4158388;4289459;3896246;0.018450;quickSort
237000;56169000000;131071;4160088;4291159;3897946;0.018501;quickSort
237100;56216410000;131071;4161788;4292859;3899646;0.018500;quickSort
237200;56263840000;131071;4163488;4294559;3901346;0.018491;quickSort
237300;56311290000;131071;4165188;4296259;3903046;0.018523;quickSort
237400;56358760000;131071;4166888;4297959;3904746;0.018474;quickSort
237500;56406250000;131071;4168588;4299659;3906446;0.018015;quickSort
237600;56453760000;131071;4170288;4301359;3908146;0.018066;quickSort
237700;56501290000;131071;4171988;4303059;3909846;0.019005;quickSort
237800;56548840000;131071;4173688;4304759;3911546;0.019008;quickSort
237900;56596410000;131071;4175388;4306459;3913246;0.018523;quickSort
238000;56644000000;131071;4177088;4308159;3914946;0.018511;quickSort
238100;56691610000;131071;4178788;4309859;3916646;0.018561;quickSort
238200;56739240000;131071;4180488;4311559;3918346;0.018857;quickSort
238300;56786890000;131071;4182188;4313259;3920046;0.018581;quickSort
238400;56834560000;131071;4183888;4314959;3921746;0.018572;quickSort
238500;56882250000;131071;4185588;4316659;3923446;0.018594;quickSort
238600;56929960000;131071;4187288;4318359;3925146;0.018626;quickSort
238700;56977690000;131071;4188988;4320059;3926846;0.018737;quickSort
238800;57025440000;131071;4190688;4321759;3928546;0.018652;quickSort
238900;57073210000;131071;4192388;4323459;3930246;0.018593;quickSort
239000;57121000000;131071;4194088;4325159;3931946;0.018690;quickSort
239100;57168810000;131071;4195788;4326859;3933646;0.018561;quickSort
239200;57216640000;131071;4197488;4328559;3935346;0.018592;quickSort
239300;57264490000;131071;4199188;4330259;3937046;0.018138;quickSort
239400;57312360000;131071;4200888;4331959;3938746;0.018166;quickSort
239500;57360250000;131071;4202588;4333659;3940446;0.018158;quickSort
239600;57408160000;131071;4204288;4335359;3942146;0.018603;quickSort
239700;57456090000;131071;4205988;4337059;3943846;0.018753;quickSort
239800;57504040000;131071;4207688;4338759;3945546;0.018675;quickSort
239900;57552010000;131071;4209388;4340459;3947246;0.018637;quickSort
240000;57600000000;131071;4211088;4342159;3948946;0.018668;quickSort
240100;57648010000;131071;4212788;4343859;3950646;0.018670;quickSort
240200;57696040000;131071;4214488;4345559;3952346;0.018754;quickSort
240300;57744090000;131071;4216188;4347259;3954046;0.018689;quickSort
240400;57792160000;131071;4217888;4348959;3955746;0.018743;quickSort
240500;57840250000;131071;4219588;4350659;3957446;0.018712;quickSort
240600;57888360000;131071;4221288;4352359;3959146;0.018637;quickSort
240700;57936490000;131071;4222988;4354059;3960846;0.018703;quickSort
240800;57984640000;131071;4224688;4355759;3962546;0.018931;quickSort
240900;58032810000;131071;4226388;4357459;3964246;0.018732;quickSort
241000;58081000000;131071;4228088;4359159;3965946;0.018687;quickSort
241100;58129210000;131071;4229788;4360859;3967646;0.018706;quickSort
241200;58177440000;131071;4231488;4362559;3969346;0.018699;quickSort
241300;58225690000;131071;4233188;4364259;3971046;0.018758;quickSort
241400;58273960000;131071;4234888;4365959;3972746;0.018765;quickSort
241500;58322250000;131071;4236588;4367659;3974446;0.018733;quickSort
241600;58370560000;131071;4238288;4369359;3976146;0.018735;quickSort
241700;58418890000;131071;4239988;4371059;3977846;0.018893;quickSort
241800;58467240000;131071;4241688;4372759;3979546;0.018828;quickSort
241900;58515610000;131071;4243388;4374459;3981246;0.019065;quickSort
242000;58564000000;131071;4245088;4376159;3982946;0.018817;quickSort
242100;58612410000;131071;4246788;4377859;3984646;0.018798;quickSort
242200;58660840000;131071;4248488;4379559;3986346;0.018786;quickSort
242300;58709290000;131071;4250188;4381259;3988046;0.018793;quickSort
242400;58757760000;131071;4251888;4382959;3989746;0.018783;quickSort
242500;58806250000;131071;4253588;4384659;3991446;0.018785;quickSort
242600;58854760000;131071;4255288;4386359;3993146;0.018781;quickSort
242700;58903290000;131071;4256988;4388059;3994846;0.018892;quickSort
242800;58951840000;131071;4258688;4389759;3996546;0.018870;quickSort
242900;59000410000;131071;4260388;4391459;3998246;0.018822;quickSort
243000;59049000000;131071;4262088;4393159;3999946;0.019569;quickSort
243100;59097610000;131071;4263788;4394859;4001646;0.018819;quickSort
243200;59146240000;131071;4265488;4396559;4003346;0.018805;quickSort
243300;59194890000;131071;4267188;4398259;4005046;0.019245;quickSort
243400;59243560000;131071;4268888;4399959;4006746;0.018910;quickSort
243500;59292250000;131071;4270588;4401659;4008446;0.018865;quickSort
243600;59340960000;131071;4272288;4403359;4010146;0.018883;quickSort
243700;59389690000;131071;4273988;4405059;4011846;0.018911;quickSort
243800;59438440000;131071;4275688;4406759;4013546;0.018914;quickSort
243900;59487210000;131071;4277388;4408459;4015246;0.018915;quickSort
244000;59536000000;131071;4279088;4410159;4016946;0.018988;quickSort
244100;59584810000;131071;4280788;4411859;4018646;0.018829;quickSort
244200;59633640000;131071;4282488;4413559;4020346;0.018876;quickSort
244300;59682490000;131071;4284188;4415259;4022046;0.018933;quickSort
244400;59731360000;131071;4285888;4416959;4023746;0.018888;quickSort
244500;59780250000;131071;4287588;4418659;4025446;0.018909;quickSort
244600;59829160000;131071;4289288;4420359;4027146;0.018918;quickSort
244700;59878090000;131071;4290988;4422059;4028846;0.018929;quickSort
244800;59927040000;131071;4292688;4423759;4030546;0.018951;quickSort
244900;59976010000;131071;4294388;4425459;4032246;0.019139;quickSort
245000;60025000000;131071;4296088;4427159;4033946;0.018947;quickSort
245100;60074010000;131071;4297788;4428859;4035646;0.018894;quickSort
245200;60123040000;131071;4299488;4430559;4037346;0.018988;quickSort
245300;60172090000;131071;4301188;4432259;4039046;0.019719;quickSort
245400;60221160000;131071;4302888;4433959;4040746;0.019075;quickSort
245500;60270250000;131071;4304588;4435659;4042446;0.018968;quickSort
245600;60319360000;131071;4306288;4437359;4044146;0.019029;quickSort
245700;60368490000;131071;4307988;4439059;4045846;0.020801;quickSort
245800;60417640000;131071;4309688;4440759;4047546;0.019121;quickSort
245900;60466810000;131071;4311388;4442459;4049246;0.018995;quickSort
246000;60516000000;131071;4313088;4444159;4050946;0.018981;quickSort
246100;60565210000;131071;4314788;4445859;4052646;0.018981;quickSort
246200;60614440000;131071;4316488;4447559;4054346;0.019031;quickSort
246300;60663690000;131071;4318188;4449259;4056046;0.018981;quickSort
246400;60712960000;131071;4319888;4450959;4057746;0.018984;quickSort
246500;60762250000;131071;4321588;4452659;4059446;0.019382;quickSort
246600;60811560000;131071;4323288;4454359;4061146;0.019021;quickSort
246700;60860890000;131071;4324988;4456059;4062846;0.019075;quickSort
246800;60910240000;131071;4326688;4457759;4064546;0.019368;quickSort
246900;60959610000;131071;4328388;4459459;4066246;0.019043;quickSort
247000;61009000000;131071;4330088;4461159;4067946;0.019030;quickSort
247100;61058410000;131071;4331788;4462859;4069646;0.019403;quickSort
247200;61107840000;131071;4333488;4464559;4071346;0.019356;quickSort
247300;61157290000;131071;4335188;4466259;4073046;0.019046;quickSort
247400;61206760000;131071;4336888;4467959;4074746;0.019087;quickSort
247500;61256250000;131071;4338588;4469659;4076446;0.019154;quickSort
247600;61305760000;131071;4340288;4471359;4078146;0.019038;quickSort
247700;61355290000;131071;4341988;4473059;4079846;0.018819;quickSort
247800;61404840000;131071;4343688;4474759;4081546;0.018646;quickSort
247900;61454410000;131071;4345388;4476459;4083246;0.018700;quickSort
248000;61504000000;131071;4347088;4478159;4084946;0.019134;quickSort
248100;61553610000;131071;4348788;4479859;4086646;0.019071;quickSort
248200;61603240000;131071;4350488;4481559;4088346;0.019126;quickSort
248300;61652890000;131071;4352188;4483259;4090046;0.019211;quickSort
248400;61702560000;131071;4353888;4484959;4091746;0.019102;quickSort
248500;61752250000;131071;4355588;4486659;4093446;0.019173;quickSort
248600;61801960000;131071;4357288;4488359;4095146;0.019256;quickSort
248700;61851690000;131071;4358988;4490059;4096846;0.019253;quickSort
248800;61901440000;131071;4360688;4491759;4098546;0.019234;quickSort
248900;61951210000;131071;4362388;4493459;4100246;0.019146;quickSort
249000;62001000000;131071;4364088;4495159;4101946;0.019201;quickSort
249100;62050810000;131071;4365788;4496859;4103646;0.019831;quickSort
249200;62100640000;131071;4367488;4498559;4105346;0.019186;quickSort
249300;62150490000;131071;4369188;4500259;4107046;0.019208;quickSort
249400;62200360000;131071;4370888;4501959;4108746;0.019727;quickSort
249500;62250250000;131071;4372588;4503659;4110446;0.019480;quickSort
249600;62300160000;131071;4374288;4505359;4112146;0.019334;quickSort
249700;62350090000;131071;4375988;4507059;4113846;0.019387;quickSort
249800;62400040000;131071;4377688;4508759;4115546;0.019259;quickSort
249900;62450010000;131071;4379388;4510459;4117246;0.019293;quickSort
250000;62500000000;131071;4381088;4512159;4118946;0.019287;quickSort
250100;62550010000;131071;4382788;4513859;4120646;0.019308;quickSort
250200;62600040000;131071;4384488;4515559;4122346;0.019224;quickSort
250300;62650090000;131071;4386188;4517259;4124046;0.019246;quickSort
250400;62700160000;131071;4387888;4518959;4125746;0.019524;quickSort
250500;62750250000;131071;4389588;4520659;4127446;0.019725;quickSort
250600;62800360000;131071;4391288;4522359;4129146;0.018856;quickSort
250700;62850490000;131071;4392988;4524059;4130846;0.020473;quickSort
250800;62900640000;131071;4394688;4525759;4132546;0.019314;quickSort
250900;62950810000;131071;4396388;4527459;4134246;0.019344;quickSort
251000;63001000000;131071;4398088;4529159;4135946;0.019309;quickSort
251100;63051210000;131071;4399788;4530859;4137646;0.019339;quickSort
251200;63101440000;131071;4401488;4532559;4139346;0.019343;quickSort
251300;63151690000;131071;4403188;4534259;4141046;0.019391;quickSort
251400;63201960000;131071;4404888;4535959;4142746;0.019368;quickSort
251500;63252250000;131071;4406588;4537659;4144446;0.019396;quickSort
251600;63302560000;131071;4408288;4539359;4146146;0.019368;quickSort
251700;63352890000;131071;4409988;4541059;4147846;0.019409;quickSort
251800;63403240000;131071;4411688;4542759;4149546;0.019425;quickSort
251900;63453610000;131071;4413388;4544459;4151246;0.019457;quickSort
252000;63504000000;131071;4415088;4546159;4152946;0.018957;quickSort
252100;63554410000;131071;4416788;4547859;4154646;0.018932;quickSort
252200;63604840000;131071;4418488;4549559;4156346;0.019117;quickSort
252300;63655290000;131071;4420188;4551259;4158046;0.021217;quickSort
252400;63705760000;131071;4421888;4552959;4159746;0.019530;quickSort
252500;63756250000;131071;4423588;4554659;4161446;0.019599;quickSort
252600;63806760000;131071;4425288;4556359;4163146;0.019705;quickSort
252700;63857290000;131071;4426988;4558059;4164846;0.019462;quickSort
252800;63907840000;131071;4428688;4559759;4166546;0.019461;quickSort
252900;63958410000;131071;4430388;4561459;4168246;0.019475;quickSort
253000;64009000000;131071;4432088;4563159;4169946;0.019464;quickSort
253100;64059610000;131071;4433788;4564859;4171646;0.019266;quickSort
253200;64110240000;131071;4435488;4566559;4173346;0.019464;quickSort
253300;64160890000;131071;4437188;4568259;4175046;0.020369;quickSort
253400;64211560000;131071;4438888;4569959;4176746;0.020218;quickSort
253500;64262250000;131071;4440588;4571659;4178446;0.020129;quickSort
253600;64312960000;131071;4442288;4573359;4180146;0.020782;quickSort
253700;64363690000;131071;4443988;4575059;4181846;0.019515;quickSort
253800;64414440000;131071;4445688;4576759;4183546;0.020302;quickSort
253900;64465210000;131071;4447388;4578459;4185246;0.019547;quickSort
254000;64516000000;131071;4449088;4580159;4186946;0.019611;quickSort
254100;64566810000;131071;4450788;4581859;4188646;0.019603;quickSort
254200;64617640000;131071;4452488;4583559;4190346;0.019577;quickSort
254300;64668490000;131071;4454188;4585259;4192046;0.020400;quickSort
254400;64719360000;131071;4455888;4586959;4193746;0.019558;quickSort
254500;64770250000;131071;4457588;4588659;4195446;0.019603;quickSort
254600;64821160000;131071;4459288;4590359;4197146;0.019598;quickSort
254700;64872090000;131071;4460988;4592059;4198846;0.019609;quickSort
254800;64923040000;131071;4462688;4593759;4200546;0.019620;quickSort
254900;64974010000;131071;4464388;4595459;4202246;0.019963;quickSort
255000;65025000000;131071;4466088;4597159;4203946;0.019950;quickSort
255100;65076010000;131071;4467788;4598859;4205646;0.019644;quickSort
255200;65127040000;131071;4469488;4600559;4207346;0.019657;quickSort
255300;65178090000;131071;4471188;4602259;4209046;0.019686;quickSort
255400;65229160000;131071;4472888;4603959;4210746;0.019716;quickSort
255500;65280250000;131071;4474588;4605659;4212446;0.019846;quickSort
255600;65331360000;131071;4476288;4607359;4214146;0.019674;quickSort
255700;65382490000;131071;4477988;4609059;4215846;0.019667;quickSort
255800;65433640000;131071;4479688;4610759;4217546;0.019656;quickSort
255900;65484810000;131071;4481388;4612459;4219246;0.020423;quickSort
256000;65536000000;131071;4483088;4614159;4220946;0.019721;quickSort
256100;65587210000;131071;4484788;4615859;4222646;0.019721;quickSort
256200;65638440000;131071;4486488;4617559;4224346;0.019746;quickSort
256300;65689690000;131071;4488188;4619259;4226046;0.019713;quickSort
256400;65740960000;131071;4489888;4620959;4227746;0.019726;quickSort
256500;65792250000;131071;4491588;4622659;4229446;0.021341;quickSort
256600;65843560000;131071;4493288;4624359;4231146;0.019723;quickSort
256700;65894890000;131071;4494988;4626059;4232846;0.019700;quickSort
256800;65946240000;131071;4496688;4627759;4234546;0.019772;quickSort
256900;65997610000;131071;4498388;4629459;4236246;0.019729;quickSort
257000;66049000000;131071;4500088;4631159;4237946;0.019773;quickSort
257100;66100410000;131071;4501788;4632859;4239646;0.019702;quickSort
257200;66151840000;131071;4503488;4634559;4241346;0.019727;quickSort
257300;66203290000;131071;4505188;4636259;4243046;0.019892;quickSort
257400;66254760000;131071;4506888;4637959;4244746;0.019776;quickSort
257500;66306250000;131071;4508588;4639659;4246446;0.019783;quickSort
257600;66357760000;131071;4510288;4641359;4248146;0.019704;quickSort
257700;66409290000;131071;4511988;4643059;4249846;0.020002;quickSort
257800;66460840000;131071;4513688;4644759;4251546;0.019786;quickSort
257900;66512410000;131071;4515388;4646459;4253246;0.021467;quickSort
258000;66564000000;131071;4517088;4648159;4254946;0.020859;quickSort
258100;66615610000;131071;4518788;4649859;4256646;0.019641;quickSort
258200;66667240000;131071;4520488;4651559;4258346;0.020502;quickSort
258300;66718890000;131071;4522188;4653259;4260046;0.020960;quickSort
258400;66770560000;131071;4523888;4654959;4261746;0.020738;quickSort
258500;66822250000;131071;4525588;4656659;4263446;0.019818;quickSort
258600;66873960000;131071;4527288;4658359;4265146;0.020359;quickSort
258700;66925690000;131071;4528988;4660059;4266846;0.020140;quickSort
258800;66977440000;131071;4530688;4661759;4268546;0.020131;quickSort
258900;67029210000;131071;4532388;4663459;4270246;0.019849;quickSort
259000;67081000000;131071;4534088;4665159;4271946;0.020059;quickSort
259100;67132810000;131071;4535788;4666859;4273646;0.019946;quickSort
259200;67184640000;131071;4537488;4668559;4275346;0.019940;quickSort
259300;67236490000;131071;4539188;4670259;4277046;0.019491;quickSort
259400;67288360000;131071;4540888;4671959;4278746;0.019355;quickSort
259500;67340250000;131071;4542588;4673659;4280446;0.019506;quickSort
259600;67392160000;131071;4544288;4675359;4282146;0.020309;quickSort
259700;67444090000;131071;4545988;4677059;4283846;0.019894;quickSort
259800;67496040000;131071;4547688;4678759;4285546;0.020457;quickSort
259900;67548010000;131071;4549388;4680459;4287246;0.020146;quickSort
260000;67600000000;131071;4551088;4682159;4288946;0.019910;quickSort
260100;67652010000;131071;4552788;4683859;4290646;0.020139;quickSort
260200;67704040000;131071;4554488;4685559;4292346;0.019935;quickSort
260300;67756090000;131071;4556188;4687259;4294046;0.019882;quickSort
260400;67808160000;131071;4557888;4688959;4295746;0.019919;quickSort
260500;67860250000;131071;4559588;4690659;4297446;0.019896;quickSort
260600;67912360000;131071;4561288;4692359;4299146;0.019948;quickSort
260700;67964490000;131071;4562988;4694059;4300846;0.019980;quickSort
260800;68016640000;131071;4564688;4695759;4302546;0.019958;quickSort
260900;68068810000;131071;4566388;4697459;4304246;0.019910;quickSort
261000;68121000000;131071;4568088;4699159;4305946;0.020185;quickSort
261100;68173210000;131071;4569788;4700859;4307646;0.020492;quickSort
261200;68225440000;131071;4571488;4702559;4309346;0.019996;quickSort
261300;68277690000;131071;4573188;4704259;4311046;0.020062;quickSort
261400;68329960000;131071;4574888;4705959;4312746;0.021868;quickSort
261500;68382250000;131071;4576588;4707659;4314446;0.024153;quickSort
261600;68434560000;131071;4578288;4709359;4316146;0.020020;quickSort
261700;68486890000;131071;4579988;4711059;4317846;0.020036;quickSort
261800;68539240000;131071;4581688;4712759;4319546;0.020039;quickSort
261900;68591610000;131071;4583388;4714459;4321246;0.020146;quickSort
262000;68644000000;131071;4585088;4716159;4322946;0.020029;quickSort
262100;68696410000;131071;4586788;4717859;4324646;0.019724;quickSort
262200;68748840000;131128;4588716;4719844;4326460;0.019508;quickSort
262300;68801290000;131228;4590816;4722044;4328360;0.020032;quickSort
262400;68853760000;131328;4592916;4724244;4330260;0.020008;quickSort
262500;68906250000;131428;4595016;4726444;4332160;0.020052;quickSort
262600;68958760000;131528;4597116;4728644;4334060;0.020113;quickSort
262700;69011290000;131628;4599216;4730844;4335960;0.020043;quickSort
262800;69063840000;131728;4601316;4733044;4337860;0.020036;quickSort
262900;69116410000;131828;4603416;4735244;4339760;0.020161;quickSort
263000;69169000000;131928;4605516;4737444;4341660;0.020234;quickSort
263100;69221610000;132028;4607616;4739644;4343560;0.020156;quickSort
263200;69274240000;132128;4609716;4741844;4345460;0.020166;quickSort
263300;69326890000;132228;4611816;4744044;4347360;0.020189;quickSort
263400;69379560000;132328;4613916;4746244;4349260;0.021721;quickSort
263500;69432250000;132428;4616016;4748444;4351160;0.020273;quickSort
263600;69484960000;132528;4618116;4750644;4353060;0.020287;quickSort
263700;69537690000;132628;4620216;4752844;4354960;0.020383;quickSort
263800;69590440000;132728;4622316;4755044;4356860;0.020281;quickSort
263900;69643210000;132828;4624416;4757244;4358760;0.020743;quickSort
264000;69696000000;132928;4626516;4759444;4360660;0.020431;quickSort
264100;69748810000;133028;4628616;4761644;4362560;0.020461;quickSort
264200;69801640000;133128;4630716;4763844;4364460;0.020237;quickSort
264300;69854490000;133228;4632816;4766044;4366360;0.020294;quickSort
264400;69907360000;133328;4634916;4768244;4368260;0.020617;quickSort
264500;69960250000;133428;4637016;4770444;4370160;0.020418;quickSort
264600;70013160000;133528;4639116;4772644;4372060;0.019925;quickSort
264700;70066090000;133628;4641216;4774844;4373960;0.019858;quickSort
264800;70119040000;133728;4643316;4777044;4375860;0.020509;quickSort
264900;70172010000;133828;4645416;4779244;4377760;0.020394;quickSort
265000;70225000000;133928;4647516;4781444;4379660;0.020496;quickSort
265100;70278010000;134028;4649616;4783644;4381560;0.020350;quickSort
265200;70331040000;134128;4651716;4785844;4383460;0.020350;quickSort
265300;70384090000;134228;4653816;4788044;4385360;0.020371;quickSort
265400;70437160000;134328;4655916;4790244;4387260;0.020860;quickSort
265500;70490250000;134428;4658016;4792444;4389160;0.020370;quickSort
265600;70543360000;134528;4660116;4794644;4391060;0.020386;quickSort
265700;70596490000;134628;4662216;4796844;4392960;0.020690;quickSort
265800;70649640000;134728;4664316;4799044;4394860;0.020837;quickSort
265900;70702810000;134828;4666416;4801244;4396760;0.020650;quickSort
266000;70756000000;134928;4668516;4803444;4398660;0.020853;quickSort
266100;70809210000;135028;4670616;4805644;4400560;0.020972;quickSort
266200;70862440000;135128;4672716;4807844;4402460;0.020932;quickSort
266300;70915690000;135228;4674816;4810044;4404360;0.021147;quickSort
266400;70968960000;135328;4676916;4812244;4406260;0.020536;quickSort
266500;71022250000;135428;4679016;4814444;4408160;0.021017;quickSort
266600;71075560000;135528;4681116;4816644;4410060;0.021099;quickSort
266700;71128890000;135628;4683216;4818844;4411960;0.020592;quickSort
266800;71182240000;135728;4685316;4821044;4413860;0.020969;quickSort
266900;71235610000;135828;4687416;4823244;4415760;0.022552;quickSort
267000;71289000000;135928;4689516;4825444;4417660;0.020605;quickSort
267100;71342410000;136028;4691616;4827644;4419560;0.020646;quickSort
267200;71395840000;136128;4693716;4829844;4421460;0.021132;quickSort
267300;71449290000;136228;4695816;4832044;4423360;0.020661;quickSort
267400;71502760000;136328;4697916;4834244;4425260;0.020660;quickSort
267500;71556250000;136428;4700016;4836444;4427160;0.020703;quickSort
267600;71609760000;136528;4702116;4838644;4429060;0.020702;quickSort
267700;71663290000;136628;4704216;4840844;4430960;0.020676;quickSort
267800;71716840000;136728;4706316;4843044;4432860;0.020681;quickSort
267900;71770410000;136828;4708416;4845244;4434760;0.020640;quickSort
268000;71824000000;136928;4710516;4847444;4436660;0.020731;quickSort
268100;71877610000;137028;4712616;4849644;4438560;0.020685;quickSort
268200;71931240000;137128;4714716;4851844;4440460;0.020810;quickSort
268300;71984890000;137228;4716816;4854044;4442360;0.021125;quickSort
268400;72038560000;137328;4718916;4856244;4444260;0.021007;quickSort
268500;72092250000;137428;4721016;4858444;4446160;0.020831;quickSort
268600;72145960000;137528;4723116;4860644;4448060;0.020818;quickSort
268700;72199690000;137628;4725216;4862844;4449960;0.021638;quickSort
268800;72253440000;137728;4727316;4865044;4451860;0.020922;quickSort
268900;72307210000;137828;4729416;4867244;4453760;0.020823;quickSort
269000;72361000000;137928;4731516;4869444;4455660;0.020897;quickSort
269100;72414810000;138028;4733616;4871644;4457560;0.020817;quickSort
269200;72468640000;138128;4735716;4873844;4459460;0.020889;quickSort
269300;72522490000;138228;4737816;4876044;4461360;0.020905;quickSort
269400;72576360000;138328;4739916;4878244;4463260;0.020921;quickSort
269500;72630250000;138428;4742016;4880444;4465160;0.020895;quickSort
269600;72684160000;138528;4744116;4882644;4467060;0.022961;quickSort
269700;72738090000;138628;4746216;4884844;4468960;0.020910;quickSort
269800;72792040000;138728;4748316;4887044;4470860;0.020973;quickSort
269900;72846010000;138828;4750416;4889244;4472760;0.020897;quickSort
270000;72900000000;138928;4752516;4891444;4474660;0.020855;quickSort
270100;72954010000;139028;4754616;4893644;4476560;0.021080;quickSort
270200;73008040000;139128;4756716;4895844;4478460;0.021123;quickSort
270300;73062090000;139228;4758816;4898044;4480360;0.021552;quickSort
270400;73116160000;139328;4760916;4900244;4482260;0.021069;quickSort
270500;73170250000;139428;4763016;4902444;4484160;0.021046;quickSort
270600;73224360000;139528;4765116;4904644;4486060;0.021066;quickSort
270700;73278490000;139628;4767216;4906844;4487960;0.021008;quickSort
270800;73332640000;139728;4769316;4909044;4489860;0.021019;quickSort
270900;73386810000;139828;4771416;4911244;4491760;0.021014;quickSort
271000;73441000000;139928;4773516;4913444;4493660;0.021061;quickSort
271100;73495210000;140028;4775616;4915644;4495560;0.023065;quickSort
271200;73549440000;140128;4777716;4917844;4497460;0.021405;quickSort
271300;73603690000;140228;4779816;4920044;4499360;0.023006;quickSort
271400;73657960000;140328;4781916;4922244;4501260;0.023758;quickSort
271500;73712250000;140428;4784016;4924444;4503160;0.021297;quickSort
271600;73766560000;140528;4786116;4926644;4505060;0.021196;quickSort
271700;73820890000;140628;4788216;4928844;4506960;0.021207;quickSort
271800;73875240000;140728;4790316;4931044;4508860;0.021154;quickSort
271900;73929610000;140828;4792416;4933244;4510760;0.021286;quickSort
272000;73984000000;140928;4794516;4935444;4512660;0.021171;quickSort
272100;74038410000;141028;4796616;4937644;4514560;0.021180;quickSort
272200;74092840000;141128;4798716;4939844;4516460;0.021107;quickSort
272300;74147290000;141228;4800816;4942044;4518360;0.021192;quickSort
272400;74201760000;141328;4802916;4944244;4520260;0.021206;quickSort
272500;74256250000;141428;4805016;4946444;4522160;0.021140;quickSort
272600;74310760000;141528;4807116;4948644;4524060;0.021212;quickSort
272700;74365290000;141628;4809216;4950844;4525960;0.021240;quickSort
272800;74419840000;141728;4811316;4953044;4527860;0.021191;quickSort
272900;74474410000;141828;4813416;4955244;4529760;0.021258;quickSort
273000;74529000000;141928;4815516;4957444;4531660;0.021202;quickSort
273100;74583610000;142028;4817616;4959644;4533560;0.021696;quickSort
273200;74638240000;142128;4819716;4961844;4535460;0.021249;quickSort
273300;74692890000;142228;4821816;4964044;4537360;0.021270;quickSort
273400;74747560000;142328;4823916;4966244;4539260;0.021315;quickSort
273500;74802250000;142428;4826016;4968444;4541160;0.021278;quickSort
273600;74856960000;142528;4828116;4970644;4543060;0.021326;quickSort
273700;74911690000;142628;4830216;4972844;4544960;0.021400;quickSort
273800;74966440000;142728;4832316;4975044;4546860;0.021351;quickSort
273900;75021210000;142828;4834416;4977244;4548760;0.021307;quickSort
274000;75076000000;142928;4836516;4979444;4550660;0.021329;quickSort
274100;75130810000;143028;4838616;4981644;4552560;0.021351;quickSort
274200;75185640000;143128;4840716;4983844;4554460;0.021398;quickSort
274300;75240490000;143228;4842816;4986044;4556360;0.021377;quickSort
274400;75295360000;143328;4844916;4988244;4558260;0.021440;quickSort
274500;75350250000;143428;4847016;4990444;4560160;0.021607;quickSort
274600;75405160000;143528;4849116;4992644;4562060;0.022224;quickSort
274700;75460090000;143628;4851216;4994844;4563960;0.021457;quickSort
274800;75515040000;143728;4853316;4997044;4565860;0.021573;quickSort
274900;75570010000;143828;4855416;4999244;4567760;0.021447;quickSort
275000;75625000000;143928;4857516;5001444;4569660;0.021466;quickSort
275100;75680010000;144028;4859616;5003644;4571560;0.021493;quickSort
275200;75735040000;144128;4861716;5005844;4573460;0.021508;quickSort
275300;75790090000;144228;4863816;5008044;4575360;0.021521;quickSort
275400;75845160000;144328;4865916;5010244;4577260;0.021539;quickSort
275500;75900250000;144428;4868016;5012444;4579160;0.025687;quickSort
275600;75955360000;144528;4870116;5014644;4581060;0.021743;quickSort
275700;76010490000;144628;4872216;5016844;4582960;0.021896;quickSort
275800;76065640000;144728;4874316;5019044;4584860;0.021682;quickSort
275900;76120810000;144828;4876416;5021244;4586760;0.021555;quickSort
276000;76176000000;144928;4878516;5023444;4588660;0.021930;quickSort
276100;76231210000;145028;4880616;5025644;4590560;0.033160;quickSort
276200;76286440000;145128;4882716;5027844;4592460;0.026492;quickSort
276300;76341690000;145228;4884816;5030044;4594360;0.022475;quickSort
276400;76396960000;145328;4886916;5032244;4596260;0.021129;quickSort
276500;76452250000;145428;4889016;5034444;4598160;0.022096;quickSort
276600;76507560000;145528;4891116;5036644;4600060;0.022098;quickSort
276700;76562890000;145628;4893216;5038844;4601960;0.022560;quickSort
276800;76618240000;145728;4895316;5041044;4603860;0.021695;quickSort
276900;76673610000;145828;4897416;5043244;4605760;0.021616;quickSort
277000;76729000000;145928;4899516;5045444;4607660;0.021769;quickSort
277100;76784410000;146028;4901616;5047644;4609560;0.021782;quickSort
277200;76839840000;146128;4903716;5049844;4611460;0.022146;quickSort
277300;76895290000;146228;4905816;5052044;4613360;0.021811;quickSort
277400;76950760000;146328;4907916;5054244;4615260;0.021651;quickSort
277500;77006250000;146428;4910016;5056444;4617160;0.021712;quickSort
277600;77061760000;146528;4912116;5058644;4619060;0.021742;quickSort
277700;77117290000;146628;4914216;5060844;4620960;0.022365;quickSort
277800;77172840000;146728;4916316;5063044;4622860;0.021938;quickSort
277900;77228410000;146828;4918416;5065244;4624760;0.021783;quickSort
278000;77284000000;146928;4920516;5067444;4626660;0.021869;quickSort
278100;77339610000;147028;4922616;5069644;4628560;0.021807;quickSort
278200;77395240000;147128;4924716;5071844;4630460;0.021806;quickSort
278300;77450890000;147228;4926816;5074044;4632360;0.021814;quickSort
278400;77506560000;147328;4928916;5076244;4634260;0.021815;quickSort
278500;77562250000;147428;4931016;5078444;4636160;0.022467;quickSort
278600;77617960000;147528;4933116;5080644;4638060;0.021879;quickSort
278700;77673690000;147628;4935216;5082844;4639960;0.021968;quickSort
278800;77729440000;147728;4937316;5085044;4641860;0.023582;quickSort
278900;77785210000;147828;4939416;5087244;4643760;0.022159;quickSort
279000;77841000000;147928;4941516;5089444;4645660;0.022349;quickSort
279100;77896810000;148028;4943616;5091644;4647560;0.021972;quickSort
279200;77952640000;148128;4945716;5093844;4649460;0.021900;quickSort
279300;78008490000;148228;4947816;5096044;4651360;0.021914;quickSort
279400;78064360000;148328;4949916;5098244;4653260;0.021936;quickSort
279500;78120250000;148428;4952016;5100444;4655160;0.021865;quickSort
279600;78176160000;148528;4954116;5102644;4657060;0.023130;quickSort
279700;78232090000;148628;4956216;5104844;4658960;0.022093;quickSort
279800;78288040000;148728;4958316;5107044;4660860;0.022172;quickSort
279900;78344010000;148828;4960416;5109244;4662760;0.023318;quickSort
280000;78400000000;148928;4962516;5111444;4664660;0.021948;quickSort
280100;78456010000;149028;4964616;5113644;4666560;0.021911;quickSort
280200;78512040000;149128;4966716;5115844;4668460;0.021953;quickSort
280300;78568090000;149228;4968816;5118044;4670360;0.022079;quickSort
280400;78624160000;149328;4970916;5120244;4672260;0.022024;quickSort
280500;78680250000;149428;4973016;5122444;4674160;0.021966;quickSort
280600;78736360000;149528;4975116;5124644;4676060;0.022300;quickSort
280700;78792490000;149628;4977216;5126844;4677960;0.022818;quickSort
280800;78848640000;149728;4979316;5129044;4679860;0.022041;quickSort
280900;78904810000;149828;4981416;5131244;4681760;0.022490;quickSort
281000;78961000000;149928;4983516;5133444;4683660;0.021522;quickSort
281100;79017210000;150028;4985616;5135644;4685560;0.021531;quickSort
281200;79073440000;150128;4987716;5137844;4687460;0.022072;quickSort
281300;79129690000;150228;4989816;5140044;4689360;0.022072;quickSort
281400;79185960000;150328;4991916;5142244;4691260;0.022141;quickSort
281500;79242250000;150428;4994016;5144444;4693160;0.022150;quickSort
281600;79298560000;150528;4996116;5146644;4695060;0.022483;quickSort
281700;79354890000;150628;4998216;5148844;4696960;0.022088;quickSort
281800;79411240000;150728;5000316;5151044;4698860;0.022117;quickSort
281900;79467610000;150828;5002416;5153244;4700760;0.022170;quickSort
282000;79524000000;150928;5004516;5155444;4702660;0.022105;quickSort
282100;79580410000;151028;5006616;5157644;4704560;0.022139;quickSort
282200;79636840000;151128;5008716;5159844;4706460;0.022180;quickSort
282300;79693290000;151228;5010816;5162044;4708360;0.022245;quickSort
282400;79749760000;151328;5012916;5164244;4710260;0.022171;quickSort
282500;79806250000;151428;5015016;5166444;4712160;0.022254;quickSort
282600;79862760000;151528;5017116;5168644;4714060;0.022152;quickSort
282700;79919290000;151628;5019216;5170844;4715960;0.022154;quickSort
282800;79975840000;151728;5021316;5173044;4717860;0.022299;quickSort
282900;80032410000;151828;5023416;5175244;4719760;0.022636;quickSort
283000;80089000000;151928;5025516;5177444;4721660;0.022435;quickSort
283100;80145610000;152028;5027616;5179644;4723560;0.022347;quickSort
283200;80202240000;152128;5029716;5181844;4725460;0.022192;quickSort
283300;80258890000;152228;5031816;5184044;4727360;0.022288;quickSort
283400;80315560000;152328;5033916;5186244;4729260;0.022278;quickSort
283500;80372250000;152428;5036016;5188444;4731160;0.023672;quickSort
283600;80428960000;152528;5038116;5190644;4733060;0.022345;quickSort
283700;80485690000;152628;5040216;5192844;4734960;0.022339;quickSort
283800;80542440000;152728;5042316;5195044;4736860;0.022977;quickSort
283900;80599210000;152828;5044416;5197244;4738760;0.023849;quickSort
284000;80656000000;152928;5046516;5199444;4740660;0.023179;quickSort
284100;80712810000;153028;5048616;5201644;4742560;0.023039;quickSort
284200;80769640000;153128;5050716;5203844;4744460;0.022394;quickSort
284300;80826490000;153228;5052816;5206044;4746360;0.022345;quickSort
284400;80883360000;153328;5054916;5208244;4748260;0.023564;quickSort
284500;80940250000;153428;5057016;5210444;4750160;0.022482;quickSort
284600;80997160000;153528;5059116;5212644;4752060;0.022404;quickSort
284700;81054090000;153628;5061216;5214844;4753960;0.022460;quickSort
284800;81111040000;153728;5063316;5217044;4755860;0.022476;quickSort
284900;81168010000;153828;5065416;5219244;4757760;0.023482;quickSort
285000;81225000000;153928;5067516;5221444;4759660;0.022393;quickSort
285100;81282010000;154028;5069616;5223644;4761560;0.022433;quickSort
285200;81339040000;154128;5071716;5225844;4763460;0.025544;quickSort
285300;81396090000;154228;5073816;5228044;4765360;0.022515;quickSort
285400;81453160000;154328;5075916;5230244;4767260;0.022498;quickSort
285500;81510250000;154428;5078016;5232444;4769160;0.022492;quickSort
285600;81567360000;154528;5080116;5234644;4771060;0.022631;quickSort
285700;81624490000;154628;5082216;5236844;4772960;0.022870;quickSort
285800;81681640000;154728;5084316;5239044;4774860;0.022471;quickSort
285900;81738810000;154828;5086416;5241244;4776760;0.022538;quickSort
286000;81796000000;154928;5088516;5243444;4778660;0.024134;quickSort
286100;81853210000;155028;5090616;5245644;4780560;0.022548;quickSort
286200;81910440000;155128;5092716;5247844;4782460;0.022515;quickSort
286300;81967690000;155228;5094816;5250044;4784360;0.022592;quickSort
286400;82024960000;155328;5096916;5252244;4786260;0.022665;quickSort
286500;82082250000;155428;5099016;5254444;4788160;0.022595;quickSort
286600;82139560000;155528;5101116;5256644;4790060;0.022611;quickSort
286700;82196890000;155628;5103216;5258844;4791960;0.023082;quickSort
286800;82254240000;155728;5105316;5261044;4793860;0.022629;quickSort
286900;82311610000;155828;5107416;5263244;4795760;0.022620;quickSort
287000;82369000000;155928;5109516;5265444;4797660;0.022641;quickSort
287100;82426410000;156028;5111616;5267644;4799560;0.022681;quickSort
287200;82483840000;156128;5113716;5269844;4801460;0.022681;quickSort
287300;82541290000;156228;5115816;5272044;4803360;0.023237;quickSort
287400;82598760000;156328;5117916;5274244;4805260;0.023246;quickSort
287500;82656250000;156428;5120016;5276444;4807160;0.022963;quickSort
287600;82713760000;156528;5122116;5278644;4809060;0.022717;quickSort
287700;82771290000;156628;5124216;5280844;4810960;0.022664;quickSort
287800;82828840000;156728;5126316;5283044;4812860;0.023029;quickSort
287900;82886410000;156828;5128416;5285244;4814760;0.022776;quickSort
288000;82944000000;156928;5130516;5287444;4816660;0.022747;quickSort
288100;83001610000;157028;5132616;5289644;4818560;0.022811;quickSort
288200;83059240000;157128;5134716;5291844;4820460;0.022835;quickSort
288300;83116890000;157228;5136816;5294044;4822360;0.023945;quickSort
288400;83174560000;157328;5138916;5296244;4824260;0.022819;quickSort
288500;83232250000;157428;5141016;5298444;4826160;0.022778;quickSort
288600;83289960000;157528;5143116;5300644;4828060;0.022781;quickSort
288700;83347690000;157628;5145216;5302844;4829960;0.022353;quickSort
288800;83405440000;157728;5147316;5305044;4831860;0.022775;quickSort
288900;83463210000;157828;5149416;5307244;4833760;0.022967;quickSort
289000;83521000000;157928;5151516;5309444;4835660;0.022821;quickSort
289100;83578810000;158028;5153616;5311644;4837560;0.022799;quickSort
289200;83636640000;158128;5155716;5313844;4839460;0.022840;quickSort
289300;83694490000;158228;5157816;5316044;4841360;0.022812;quickSort
289400;83752360000;158328;5159916;5318244;4843260;0.022827;quickSort
289500;83810250000;158428;5162016;5320444;4845160;0.023408;quickSort
289600;83868160000;158528;5164116;5322644;4847060;0.022848;quickSort
289700;83926090000;158628;5166216;5324844;4848960;0.023773;quickSort
289800;83984040000;158728;5168316;5327044;4850860;0.023227;quickSort
289900;84042010000;158828;5170416;5329244;4852760;0.022897;quickSort
290000;84100000000;158928;5172516;5331444;4854660;0.022894;quickSort
290100;84158010000;159028;5174616;5333644;4856560;0.022934;quickSort
290200;84216040000;159128;5176716;5335844;4858460;0.022954;quickSort
290300;84274090000;159228;5178816;5338044;4860360;0.022906;quickSort
290400;84332160000;159328;5180916;5340244;4862260;0.022721;quickSort
290500;84390250000;159428;5183016;5342444;4864160;0.024175;quickSort
290600;84448360000;159528;5185116;5344644;4866060;0.023584;quickSort
290700;84506490000;159628;5187216;5346844;4867960;0.022967;quickSort
290800;84564640000;159728;5189316;5349044;4869860;0.023773;quickSort
290900;84622810000;159828;5191416;5351244;4871760;0.023500;quickSort
291000;84681000000;159928;5193516;5353444;4873660;0.023719;quickSort
291100;84739210000;160028;5195616;5355644;4875560;0.023293;quickSort
291200;84797440000;160128;5197716;5357844;4877460;0.023337;quickSort
291300;84855690000;160228;5199816;5360044;4879360;0.023253;quickSort
291400;84913960000;160328;5201916;5362244;4881260;0.023029;quickSort
291500;84972250000;160428;5204016;5364444;4883160;0.023051;quickSort
291600;85030560000;160528;5206116;5366644;4885060;0.022983;quickSort
291700;85088890000;160628;5208216;5368844;4886960;0.024906;quickSort
291800;85147240000;160728;5210316;5371044;4888860;0.023194;quickSort
291900;85205610000;160828;5212416;5373244;4890760;0.023135;quickSort
292000;85264000000;160928;5214516;5375444;4892660;0.023156;quickSort
292100;85322410000;161028;5216616;5377644;4894560;0.023158;quickSort
292200;85380840000;161128;5218716;5379844;4896460;0.023174;quickSort
292300;85439290000;161228;5220816;5382044;4898360;0.023159;quickSort
292400;85497760000;161328;5222916;5384244;4900260;0.023192;quickSort
292500;85556250000;161428;5225016;5386444;4902160;0.023649;quickSort
292600;85614760000;161528;5227116;5388644;4904060;0.023151;quickSort
292700;85673290000;161628;5229216;5390844;4905960;0.023143;quickSort
292800;85731840000;161728;5231316;5393044;4907860;0.023061;quickSort
292900;85790410000;161828;5233416;5395244;4909760;0.023131;quickSort
293000;85849000000;161928;5235516;5397444;4911660;0.023180;quickSort
293100;85907610000;162028;5237616;5399644;4913560;0.023141;quickSort
293200;85966240000;162128;5239716;5401844;4915460;0.023347;quickSort
293300;86024890000;162228;5241816;5404044;4917360;0.023323;quickSort
293400;86083560000;162328;5243916;5406244;4919260;0.023173;quickSort
293500;86142250000;162428;5246016;5408444;4921160;0.023186;quickSort
293600;86200960000;162528;5248116;5410644;4923060;0.023178;quickSort
293700;86259690000;162628;5250216;5412844;4924960;0.023185;quickSort
293800;86318440000;162728;5252316;5415044;4926860;0.023360;quickSort
293900;86377210000;162828;5254416;5417244;4928760;0.023341;quickSort
294000;86436000000;162928;5256516;5419444;4930660;0.024107;quickSort
294100;86494810000;163028;5258616;5421644;4932560;0.023957;quickSort
294200;86553640000;163128;5260716;5423844;4934460;0.023445;quickSort
294300;86612490000;163228;5262816;5426044;4936360;0.023965;quickSort
294400;86671360000;163328;5264916;5428244;4938260;0.023274;quickSort
294500;86730250000;163428;5267016;5430444;4940160;0.023318;quickSort
294600;86789160000;163528;5269116;5432644;4942060;0.023290;quickSort
294700;86848090000;163628;5271216;5434844;4943960;0.023430;quickSort
294800;86907040000;163728;5273316;5437044;4945860;0.023375;quickSort
294900;86966010000;163828;5275416;5439244;4947760;0.023889;quickSort
295000;87025000000;163928;5277516;5441444;4949660;0.023519;quickSort
295100;87084010000;164028;5279616;5443644;4951560;0.023303;quickSort
295200;87143040000;164128;5281716;5445844;4953460;0.023258;quickSort
295300;87202090000;164228;5283816;5448044;4955360;0.023346;quickSort
295400;87261160000;164328;5285916;5450244;4957260;0.023385;quickSort
295500;87320250000;164428;5288016;5452444;4959160;0.023636;quickSort
295600;87379360000;164528;5290116;5454644;4961060;0.024958;quickSort
295700;87438490000;164628;5292216;5456844;4962960;0.023540;quickSort
295800;87497640000;164728;5294316;5459044;4964860;0.023397;quickSort
295900;87556810000;164828;5296416;5461244;4966760;0.023497;quickSort
296000;87616000000;164928;5298516;5463444;4968660;0.023630;quickSort
296100;87675210000;165028;5300616;5465644;4970560;0.024116;quickSort
296200;87734440000;165128;5302716;5467844;4972460;0.025321;quickSort
296300;87793690000;165228;5304816;5470044;4974360;0.023641;quickSort
296400;87852960000;165328;5306916;5472244;4976260;0.023751;quickSort
296500;87912250000;165428;5309016;5474444;4978160;0.023641;quickSort
296600;87971560000;165528;5311116;5476644;4980060;0.023626;quickSort
296700;88030890000;165628;5313216;5478844;4981960;0.023828;quickSort
296800;88090240000;165728;5315316;5481044;4983860;0.023500;quickSort
296900;88149610000;165828;5317416;5483244;4985760;0.024425;quickSort
297000;88209000000;165928;5319516;5485444;4987660;0.023598;quickSort
297100;88268410000;166028;5321616;5487644;4989560;0.023528;quickSort
297200;88327840000;166128;5323716;5489844;4991460;0.023119;quickSort
297300;88387290000;166228;5325816;5492044;4993360;0.023330;quickSort
297400;88446760000;166328;5327916;5494244;4995260;0.023606;quickSort
297500;88506250000;166428;5330016;5496444;4997160;0.023606;quickSort
297600;88565760000;166528;5332116;5498644;4999060;0.023551;quickSort
297700;88625290000;166628;5334216;5500844;5000960;0.023695;quickSort
297800;88684840000;166728;5336316;5503044;5002860;0.023572;quickSort
297900;88744410000;166828;5338416;5505244;5004760;0.024130;quickSort
298000;88804000000;166928;5340516;5507444;5006660;0.023708;quickSort
298100;88863610000;167028;5342616;5509644;5008560;0.023633;quickSort
298200;88923240000;167128;5344716;5511844;5010460;0.023632;quickSort
298300;88982890000;167228;5346816;5514044;5012360;0.023676;quickSort
298400;89042560000;167328;5348916;5516244;5014260;0.024079;quickSort
298500;89102250000;167428;5351016;5518444;5016160;0.024528;quickSort
298600;89161960000;167528;5353116;5520644;5018060;0.023677;quickSort
298700;89221690000;167628;5355216;5522844;5019960;0.025229;quickSort
298800;89281440000;167728;5357316;5525044;5021860;0.023700;quickSort
298900;89341210000;167828;5359416;5527244;5023760;0.023665;quickSort
299000;89401000000;167928;5361516;5529444;5025660;0.023739;quickSort
299100;89460810000;168028;5363616;5531644;5027560;0.023704;quickSort
299200;89520640000;168128;5365716;5533844;5029460;0.023882;quickSort
299300;89580490000;168228;5367816;5536044;5031360;0.024196;quickSort
299400;89640360000;168328;5369916;5538244;5033260;0.023783;quickSort
299500;89700250000;168428;5372016;5540444;5035160;0.023885;quickSort
299600;89760160000;168528;5374116;5542644;5037060;0.039211;quickSort
299700;89820090000;168628;5376216;5544844;5038960;0.026603;quickSort
299800;89880040000;168728;5378316;5547044;5040860;0.023789;quickSort
299900;89940010000;168828;5380416;5549244;5042760;0.023810;quickSort
300000;90000000000;168928;5382516;5551444;5044660;0.023918;quickSort
300100;90060010000;169028;5384616;5553644;5046560;0.024128;quickSort
300200;90120040000;169128;5386716;5555844;5048460;0.023873;quickSort
300300;90180090000;169228;5388816;5558044;5050360;0.023943;quickSort
300400;90240160000;169328;5390916;5560244;5052260;0.024716;quickSort
300500;90300250000;169428;5393016;5562444;5054160;0.023913;quickSort
300600;90360360000;169528;5395116;5564644;5056060;0.023903;quickSort
300700;90420490000;169628;5397216;5566844;5057960;0.023867;quickSort
300800;90480640000;169728;5399316;5569044;5059860;0.023888;quickSort
300900;90540810000;169828;5401416;5571244;5061760;0.023910;quickSort
301000;90601000000;169928;5403516;5573444;5063660;0.023975;quickSort
301100;90661210000;170028;5405616;5575644;5065560;0.024031;quickSort
301200;90721440000;170128;5407716;5577844;5067460;0.023932;quickSort
301300;90781690000;170228;5409816;5580044;5069360;0.024425;quickSort
301400;90841960000;170328;5411916;5582244;5071260;0.024782;quickSort
301500;90902250000;170428;5414016;5584444;5073160;0.023982;quickSort
301600;90962560000;170528;5416116;5586644;5075060;0.024006;quickSort
301700;91022890000;170628;5418216;5588844;5076960;0.024046;quickSort
301800;91083240000;170728;5420316;5591044;5078860;0.024147;quickSort
301900;91143610000;170828;5422416;5593244;5080760;0.024109;quickSort
302000;91204000000;170928;5424516;5595444;5082660;0.024069;quickSort
302100;91264410000;171028;5426616;5597644;5084560;0.024791;quickSort
302200;91324840000;171128;5428716;5599844;5086460;0.024045;quickSort
302300;91385290000;171228;5430816;5602044;5088360;0.024078;quickSort
302400;91445760000;171328;5432916;5604244;5090260;0.024082;quickSort
302500;91506250000;171428;5435016;5606444;5092160;0.024109;quickSort
302600;91566760000;171528;5437116;5608644;5094060;0.024424;quickSort
302700;91627290000;171628;5439216;5610844;5095960;0.024635;quickSort
302800;91687840000;171728;5441316;5613044;5097860;0.024151;quickSort
302900;91748410000;171828;5443416;5615244;5099760;0.024169;quickSort
303000;91809000000;171928;5445516;5617444;5101660;0.024232;quickSort
303100;91869610000;172028;5447616;5619644;5103560;0.024173;quickSort
303200;91930240000;172128;5449716;5621844;5105460;0.024168;quickSort
303300;91990890000;172228;5451816;5624044;5107360;0.024224;quickSort
303400;92051560000;172328;5453916;5626244;5109260;0.026682;quickSort
303500;92112250000;172428;5456016;5628444;5111160;0.025019;quickSort
303600;92172960000;172528;5458116;5630644;5113060;0.024318;quickSort
303700;92233690000;172628;5460216;5632844;5114960;0.024268;quickSort
303800;92294440000;172728;5462316;5635044;5116860;0.024311;quickSort
303900;92355210000;172828;5464416;5637244;5118760;0.024423;quickSort
304000;92416000000;172928;5466516;5639444;5120660;0.024427;quickSort
304100;92476810000;173028;5468616;5641644;5122560;0.024346;quickSort
304200;92537640000;173128;5470716;5643844;5124460;0.023669;quickSort
304300;92598490000;173228;5472816;5646044;5126360;0.023908;quickSort
304400;92659360000;173328;5474916;5648244;5128260;0.024550;quickSort
304500;92720250000;173428;5477016;5650444;5130160;0.024329;quickSort
304600;92781160000;173528;5479116;5652644;5132060;0.024326;quickSort
304700;92842090000;173628;5481216;5654844;5133960;0.024331;quickSort
304800;92903040000;173728;5483316;5657044;5135860;0.024707;quickSort
304900;92964010000;173828;5485416;5659244;5137760;0.024402;quickSort
305000;93025000000;173928;5487516;5661444;5139660;0.024429;quickSort
305100;93086010000;174028;5489616;5663644;5141560;0.024347;quickSort
305200;93147040000;174128;5491716;5665844;5143460;0.024321;quickSort
305300;93208090000;174228;5493816;5668044;5145360;0.024304;quickSort
305400;93269160000;174328;5495916;5670244;5147260;0.024370;quickSort
305500;93330250000;174428;5498016;5672444;5149160;0.024385;quickSort
305600;93391360000;174528;5500116;5674644;5151060;0.024482;quickSort
305700;93452490000;174628;5502216;5676844;5152960;0.024566;quickSort
305800;93513640000;174728;5504316;5679044;5154860;0.024589;quickSort
305900;93574810000;174828;5506416;5681244;5156760;0.024424;quickSort
306000;93636000000;174928;5508516;5683444;5158660;0.024483;quickSort
306100;93697210000;175028;5510616;5685644;5160560;0.024446;quickSort
306200;93758440000;175128;5512716;5687844;5162460;0.024444;quickSort
306300;93819690000;175228;5514816;5690044;5164360;0.025022;quickSort
306400;93880960000;175328;5516916;5692244;5166260;0.024549;quickSort
306500;93942250000;175428;5519016;5694444;5168160;0.024559;quickSort
306600;94003560000;175528;5521116;5696644;5170060;0.024699;quickSort
306700;94064890000;175628;5523216;5698844;5171960;0.025025;quickSort
306800;94126240000;175728;5525316;5701044;5173860;0.025315;quickSort
306900;94187610000;175828;5527416;5703244;5175760;0.024520;quickSort
307000;94249000000;175928;5529516;5705444;5177660;0.024614;quickSort
307100;94310410000;176028;5531616;5707644;5179560;0.024543;quickSort
307200;94371840000;176128;5533716;5709844;5181460;0.025045;quickSort
307300;94433290000;176228;5535816;5712044;5183360;0.025276;quickSort
307400;94494760000;176328;5537916;5714244;5185260;0.024671;quickSort
307500;94556250000;176428;5540016;5716444;5187160;0.024624;quickSort
307600;94617760000;176528;5542116;5718644;5189060;0.024661;quickSort
307700;94679290000;176628;5544216;5720844;5190960;0.024672;quickSort
307800;94740840000;176728;5546316;5723044;5192860;0.024630;quickSort
307900;94802410000;176828;5548416;5725244;5194760;0.024671;quickSort
308000;94864000000;176928;5550516;5727444;5196660;0.024700;quickSort
308100;94925610000;177028;5552616;5729644;5198560;0.024731;quickSort
308200;94987240000;177128;5554716;5731844;5200460;0.024653;quickSort
308300;95048890000;177228;5556816;5734044;5202360;0.024649;quickSort
308400;95110560000;177328;5558916;5736244;5204260;0.024694;quickSort
308500;95172250000;177428;5561016;5738444;5206160;0.024658;quickSort
308600;95233960000;177528;5563116;5740644;5208060;0.024623;quickSort
308700;95295690000;177628;5565216;5742844;5209960;0.024709;quickSort
308800;95357440000;177728;5567316;5745044;5211860;0.024705;quickSort
308900;95419210000;177828;5569416;5747244;5213760;0.024738;quickSort
309000;95481000000;177928;5571516;5749444;5215660;0.024765;quickSort
309100;95542810000;178028;5573616;5751644;5217560;0.026627;quickSort
309200;95604640000;178128;5575716;5753844;5219460;0.024874;quickSort
309300;95666490000;178228;5577816;5756044;5221360;0.025060;quickSort
309400;95728360000;178328;5579916;5758244;5223260;0.024774;quickSort
309500;95790250000;178428;5582016;5760444;5225160;0.025339;quickSort
309600;95852160000;178528;5584116;5762644;5227060;0.025127;quickSort
309700;95914090000;178628;5586216;5764844;5228960;0.024804;quickSort
309800;95976040000;178728;5588316;5767044;5230860;0.024850;quickSort
309900;96038010000;178828;5590416;5769244;5232760;0.024791;quickSort
310000;96100000000;178928;5592516;5771444;5234660;0.026882;quickSort
310100;96162010000;179028;5594616;5773644;5236560;0.026237;quickSort
310200;96224040000;179128;5596716;5775844;5238460;0.025178;quickSort
310300;96286090000;179228;5598816;5778044;5240360;0.025340;quickSort
310400;96348160000;179328;5600916;5780244;5242260;0.024962;quickSort
310500;96410250000;179428;5603016;5782444;5244160;0.024823;quickSort
310600;96472360000;179528;5605116;5784644;5246060;0.024877;quickSort
310700;96534490000;179628;5607216;5786844;5247960;0.024858;quickSort
310800;96596640000;179728;5609316;5789044;5249860;0.024894;quickSort
310900;96658810000;179828;5611416;5791244;5251760;0.026409;quickSort
311000;96721000000;179928;5613516;5793444;5253660;0.025794;quickSort
311100;96783210000;180028;5615616;5795644;5255560;0.027206;quickSort
311200;96845440000;180128;5617716;5797844;5257460;0.026410;quickSort
311300;96907690000;180228;5619816;5800044;5259360;0.025472;quickSort
311400;96969960000;180328;5621916;5802244;5261260;0.026207;quickSort
311500;97032250000;180428;5624016;5804444;5263160;0.025836;quickSort
311600;97094560000;180528;5626116;5806644;5265060;0.024998;quickSort
311700;97156890000;180628;5628216;5808844;5266960;0.024938;quickSort
311800;97219240000;180728;5630316;5811044;5268860;0.024995;quickSort
311900;97281610000;180828;5632416;5813244;5270760;0.025397;quickSort
312000;97344000000;180928;5634516;5815444;5272660;0.025171;quickSort
312100;97406410000;181028;5636616;5817644;5274560;0.025224;quickSort
312200;97468840000;181128;5638716;5819844;5276460;0.027030;quickSort
312300;97531290000;181228;5640816;5822044;5278360;0.025006;quickSort
312400;97593760000;181328;5642916;5824244;5280260;0.024992;quickSort
312500;97656250000;181428;5645016;5826444;5282160;0.025446;quickSort
312600;97718760000;181528;5647116;5828644;5284060;0.025621;quickSort
312700;97781290000;181628;5649216;5830844;5285960;0.025570;quickSort
312800;97843840000;181728;5651316;5833044;5287860;0.025143;quickSort
312900;97906410000;181828;5653416;5835244;5289760;0.025058;quickSort
313000;97969000000;181928;5655516;5837444;5291660;0.025091;quickSort
313100;98031610000;182028;5657616;5839644;5293560;0.025109;quickSort
313200;98094240000;182128;5659716;5841844;5295460;0.025190;quickSort
313300;98156890000;182228;5661816;5844044;5297360;0.025272;quickSort
313400;98219560000;182328;5663916;5846244;5299260;0.025181;quickSort
313500;98282250000;182428;5666016;5848444;5301160;0.025203;quickSort
313600;98344960000;182528;5668116;5850644;5303060;0.025184;quickSort
313700;98407690000;182628;5670216;5852844;5304960;0.025179;quickSort
313800;98470440000;182728;5672316;5855044;5306860;0.026221;quickSort
313900;98533210000;182828;5674416;5857244;5308760;0.025861;quickSort
314000;98596000000;182928;5676516;5859444;5310660;0.025340;quickSort
314100;98658810000;183028;5678616;5861644;5312560;0.025362;quickSort
314200;98721640000;183128;5680716;5863844;5314460;0.025271;quickSort
314300;98784490000;183228;5682816;5866044;5316360;0.025332;quickSort
314400;98847360000;183328;5684916;5868244;5318260;0.025281;quickSort
314500;98910250000;183428;5687016;5870444;5320160;0.025210;quickSort
314600;98973160000;183528;5689116;5872644;5322060;0.025788;quickSort
314700;99036090000;183628;5691216;5874844;5323960;0.025343;quickSort
314800;99099040000;183728;5693316;5877044;5325860;0.025305;quickSort
314900;99162010000;183828;5695416;5879244;5327760;0.026009;quickSort
315000;99225000000;183928;5697516;5881444;5329660;0.025506;quickSort
315100;99288010000;184028;5699616;5883644;5331560;0.025715;quickSort
315200;99351040000;184128;5701716;5885844;5333460;0.026944;quickSort
315300;99414090000;184228;5703816;5888044;5335360;0.025410;quickSort
315400;99477160000;184328;5705916;5890244;5337260;0.025669;quickSort
315500;99540250000;184428;5708016;5892444;5339160;0.025505;quickSort
315600;99603360000;184528;5710116;5894644;5341060;0.025428;quickSort
315700;99666490000;184628;5712216;5896844;5342960;0.026245;quickSort
315800;99729640000;184728;5714316;5899044;5344860;0.025742;quickSort
315900;99792810000;184828;5716416;5901244;5346760;0.025634;quickSort
316000;99856000000;184928;5718516;5903444;5348660;0.025006;quickSort
316100;99919210000;185028;5720616;5905644;5350560;0.024809;quickSort
316200;99982440000;185128;5722716;5907844;5352460;0.025235;quickSort
316300;100045690000;185228;5724816;5910044;5354360;0.025516;quickSort
316400;100108960000;185328;5726916;5912244;5356260;0.025573;quickSort
316500;100172250000;185428;5729016;5914444;5358160;0.025484;quickSort
316600;100235560000;185528;5731116;5916644;5360060;0.025490;quickSort
316700;100298890000;185628;5733216;5918844;5361960;0.027063;quickSort
316800;100362240000;185728;5735316;5921044;5363860;0.025727;quickSort
316900;100425610000;185828;5737416;5923244;5365760;0.025804;quickSort
317000;100489000000;185928;5739516;5925444;5367660;0.025553;quickSort
317100;100552410000;186028;5741616;5927644;5369560;0.025639;quickSort
317200;100615840000;186128;5743716;5929844;5371460;0.025575;quickSort
317300;100679290000;186228;5745816;5932044;5373360;0.025567;quickSort
317400;100742760000;186328;5747916;5934244;5375260;0.026881;quickSort
317500;100806250000;186428;5750016;5936444;5377160;0.025580;quickSort
317600;100869760000;186528;5752116;5938644;5379060;0.025605;quickSort
317700;100933290000;186628;5754216;5940844;5380960;0.025656;quickSort
317800;100996840000;186728;5756316;5943044;5382860;0.025934;quickSort
317900;101060410000;186828;5758416;5945244;5384760;0.025653;quickSort
318000;101124000000;186928;5760516;5947444;5386660;0.026157;quickSort
318100;101187610000;187028;5762616;5949644;5388560;0.025865;quickSort
318200;101251240000;187128;5764716;5951844;5390460;0.026504;quickSort
318300;101314890000;187228;5766816;5954044;5392360;0.026025;quickSort
318400;101378560000;187328;5768916;5956244;5394260;0.026690;quickSort
318500;101442250000;187428;5771016;5958444;5396160;0.027482;quickSort
318600;101505960000;187528;5773116;5960644;5398060;0.025892;quickSort
318700;101569690000;187628;5775216;5962844;5399960;0.027696;quickSort
318800;101633440000;187728;5777316;5965044;5401860;0.025063;quickSort
318900;101697210000;187828;5779416;5967244;5403760;0.025747;quickSort
319000;101761000000;187928;5781516;5969444;5405660;0.026064;quickSort
319100;101824810000;188028;5783616;5971644;5407560;0.025760;quickSort
319200;101888640000;188128;5785716;5973844;5409460;0.025940;quickSort
319300;101952490000;188228;5787816;5976044;5411360;0.025824;quickSort
319400;102016360000;188328;5789916;5978244;5413260;0.025749;quickSort
319500;102080250000;188428;5792016;5980444;5415160;0.025875;quickSort
319600;102144160000;188528;5794116;5982644;5417060;0.025858;quickSort
319700;102208090000;188628;5796216;5984844;5418960;0.025768;quickSort
319800;102272040000;188728;5798316;5987044;5420860;0.025867;quickSort
319900;102336010000;188828;5800416;5989244;5422760;0.025836;quickSort
320000;102400000000;188928;5802516;5991444;5424660;0.026290;quickSort
320100;102464010000;189028;5804616;5993644;5426560;0.025163;quickSort
320200;102528040000;189128;5806716;5995844;5428460;0.025195;quickSort
320300;102592090000;189228;5808816;5998044;5430360;0.025695;quickSort
320400;102656160000;189328;5810916;6000244;5432260;0.025887;quickSort
320500;102720250000;189428;5813016;6002444;5434160;0.025838;quickSort
320600;102784360000;189528;5815116;6004644;5436060;0.025907;quickSort
320700;102848490000;189628;5817216;6006844;5437960;0.025949;quickSort
320800;102912640000;189728;5819316;6009044;5439860;0.027483;quickSort
320900;102976810000;189828;5821416;6011244;5441760;0.026021;quickSort
321000;103041000000;189928;5823516;6013444;5443660;0.026071;quickSort
321100;103105210000;190028;5825616;6015644;5445560;0.026026;quickSort
321200;103169440000;190128;5827716;6017844;5447460;0.025985;quickSort
321300;103233690000;190228;5829816;6020044;5449360;0.025997;quickSort
321400;103297960000;190328;5831916;6022244;5451260;0.026078;quickSort
321500;103362250000;190428;5834016;6024444;5453160;0.026742;quickSort
321600;103426560000;190528;5836116;6026644;5455060;0.025996;quickSort
321700;103490890000;190628;5838216;6028844;5456960;0.026012;quickSort
321800;103555240000;190728;5840316;6031044;5458860;0.026021;quickSort
321900;103619610000;190828;5842416;6033244;5460760;0.026328;quickSort
322000;103684000000;190928;5844516;6035444;5462660;0.026058;quickSort
322100;103748410000;191028;5846616;6037644;5464560;0.026190;quickSort
322200;103812840000;191128;5848716;6039844;5466460;0.026131;quickSort
322300;103877290000;191228;5850816;6042044;5468360;0.026059;quickSort
322400;103941760000;191328;5852916;6044244;5470260;0.026217;quickSort
322500;104006250000;191428;5855016;6046444;5472160;0.026103;quickSort
322600;104070760000;191528;5857116;6048644;5474060;0.026123;quickSort
322700;104135290000;191628;5859216;6050844;5475960;0.025480;quickSort
322800;104199840000;191728;5861316;6053044;5477860;0.025592;quickSort
322900;104264410000;191828;5863416;6055244;5479760;0.026642;quickSort
323000;104329000000;191928;5865516;6057444;5481660;0.026167;quickSort
323100;104393610000;192028;5867616;6059644;5483560;0.028082;quickSort
323200;104458240000;192128;5869716;6061844;5485460;0.025490;quickSort
323300;104522890000;192228;5871816;6064044;5487360;0.025510;quickSort
323400;104587560000;192328;5873916;6066244;5489260;0.026161;quickSort
323500;104652250000;192428;5876016;6068444;5491160;0.026688;quickSort
323600;104716960000;192528;5878116;6070644;5493060;0.026390;quickSort
323700;104781690000;192628;5880216;6072844;5494960;0.027346;quickSort
323800;104846440000;192728;5882316;6075044;5496860;0.026327;quickSort
323900;104911210000;192828;5884416;6077244;5498760;0.026207;quickSort
324000;104976000000;192928;5886516;6079444;5500660;0.026222;quickSort
324100;105040810000;193028;5888616;6081644;5502560;0.026216;quickSort
324200;105105640000;193128;5890716;6083844;5504460;0.026274;quickSort
324300;105170490000;193228;5892816;6086044;5506360;0.026294;quickSort
324400;105235360000;193328;5894916;6088244;5508260;0.026734;quickSort
324500;105300250000;193428;5897016;6090444;5510160;0.026350;quickSort
324600;105365160000;193528;5899116;6092644;5512060;0.026321;quickSort
324700;105430090000;193628;5901216;6094844;5513960;0.026364;quickSort
324800;105495040000;193728;5903316;6097044;5515860;0.026335;quickSort
324900;105560010000;193828;5905416;6099244;5517760;0.026346;quickSort
325000;105625000000;193928;5907516;6101444;5519660;0.026583;quickSort
325100;105690010000;194028;5909616;6103644;5521560;0.027132;quickSort
325200;105755040000;194128;5911716;6105844;5523460;0.026591;quickSort
325300;105820090000;194228;5913816;6108044;5525360;0.026403;quickSort
325400;105885160000;194328;5915916;6110244;5527260;0.026447;quickSort
325500;105950250000;194428;5918016;6112444;5529160;0.026456;quickSort
325600;106015360000;194528;5920116;6114644;5531060;0.026372;quickSort
325700;106080490000;194628;5922216;6116844;5532960;0.026416;quickSort
325800;106145640000;194728;5924316;6119044;5534860;0.026578;quickSort
325900;106210810000;194828;5926416;6121244;5536760;0.027106;quickSort
326000;106276000000;194928;5928516;6123444;5538660;0.025774;quickSort
326100;106341210000;195028;5930616;6125644;5540560;0.025938;quickSort
326200;106406440000;195128;5932716;6127844;5542460;0.026555;quickSort
326300;106471690000;195228;5934816;6130044;5544360;0.025778;quickSort
326400;106536960000;195328;5936916;6132244;5546260;0.026494;quickSort
326500;106602250000;195428;5939016;6134444;5548160;0.025794;quickSort
326600;106667560000;195528;5941116;6136644;5550060;0.027609;quickSort
326700;106732890000;195628;5943216;6138844;5551960;0.027224;quickSort
326800;106798240000;195728;5945316;6141044;5553860;0.026675;quickSort
326900;106863610000;195828;5947416;6143244;5555760;0.026464;quickSort
327000;106929000000;195928;5949516;6145444;5557660;0.026645;quickSort
327100;106994410000;196028;5951616;6147644;5559560;0.028509;quickSort
327200;107059840000;196128;5953716;6149844;5561460;0.026825;quickSort
327300;107125290000;196228;5955816;6152044;5563360;0.029725;quickSort
327400;107190760000;196328;5957916;6154244;5565260;0.027819;quickSort
327500;107256250000;196428;5960016;6156444;5567160;0.026729;quickSort
327600;107321760000;196528;5962116;6158644;5569060;0.026819;quickSort
327700;107387290000;196628;5964216;6160844;5570960;0.026552;quickSort
327800;107452840000;196728;5966316;6163044;5572860;0.027249;quickSort
327900;107518410000;196828;5968416;6165244;5574760;0.026592;quickSort
328000;107584000000;196928;5970516;6167444;5576660;0.026587;quickSort
328100;107649610000;197028;5972616;6169644;5578560;0.026585;quickSort
328200;107715240000;197128;5974716;6171844;5580460;0.026554;quickSort
328300;107780890000;197228;5976816;6174044;5582360;0.026383;quickSort
328400;107846560000;197328;5978916;6176244;5584260;0.026089;quickSort
328500;107912250000;197428;5981016;6178444;5586160;0.026023;quickSort
328600;107977960000;197528;5983116;6180644;5588060;0.026968;quickSort
328700;108043690000;197628;5985216;6182844;5589960;0.026652;quickSort
328800;108109440000;197728;5987316;6185044;5591860;0.026726;quickSort
328900;108175210000;197828;5989416;6187244;5593760;0.026709;quickSort
329000;108241000000;197928;5991516;6189444;5595660;0.026748;quickSort
329100;108306810000;198028;5993616;6191644;5597560;0.026760;quickSort
329200;108372640000;198128;5995716;6193844;5599460;0.026949;quickSort
329300;108438490000;198228;5997816;6196044;5601360;0.026796;quickSort
329400;108504360000;198328;5999916;6198244;5603260;0.026882;quickSort
329500;108570250000;198428;6002016;6200444;5605160;0.026804;quickSort
329600;108636160000;198528;6004116;6202644;5607060;0.026805;quickSort
329700;108702090000;198628;6006216;6204844;5608960;0.026825;quickSort
329800;108768040000;198728;6008316;6207044;5610860;0.026845;quickSort
329900;108834010000;198828;6010416;6209244;5612760;0.026808;quickSort
330000;108900000000;198928;6012516;6211444;5614660;0.026843;quickSort
330100;108966010000;199028;6014616;6213644;5616560;0.027442;quickSort
330200;109032040000;199128;6016716;6215844;5618460;0.026872;quickSort
330300;109098090000;199228;6018816;6218044;5620360;0.026873;quickSort
330400;109164160000;199328;6020916;6220244;5622260;0.026858;quickSort
330500;109230250000;199428;6023016;6222444;5624160;0.027210;quickSort
330600;109296360000;199528;6025116;6224644;5626060;0.026894;quickSort
330700;109362490000;199628;6027216;6226844;5627960;0.027745;quickSort
330800;109428640000;199728;6029316;6229044;5629860;0.027322;quickSort
330900;109494810000;199828;6031416;6231244;5631760;0.028641;quickSort
331000;109561000000;199928;6033516;6233444;5633660;0.027030;quickSort
331100;109627210000;200028;6035616;6235644;5635560;0.027025;quickSort
331200;109693440000;200128;6037716;6237844;5637460;0.026940;quickSort
331300;109759690000;200228;6039816;6240044;5639360;0.027957;quickSort
331400;109825960000;200328;6041916;6242244;5641260;0.027058;quickSort
331500;109892250000;200428;6044016;6244444;5643160;0.027086;quickSort
331600;109958560000;200528;6046116;6246644;5645060;0.027092;quickSort
331700;110024890000;200628;6048216;6248844;5646960;0.027040;quickSort
331800;110091240000;200728;6050316;6251044;5648860;0.027044;quickSort
331900;110157610000;200828;6052416;6253244;5650760;0.027250;quickSort
332000;110224000000;200928;6054516;6255444;5652660;0.029355;quickSort
332100;110290410000;201028;6056616;6257644;5654560;0.027064;quickSort
332200;110356840000;201128;6058716;6259844;5656460;0.027337;quickSort
332300;110423290000;201228;6060816;6262044;5658360;0.027447;quickSort
332400;110489760000;201328;6062916;6264244;5660260;0.027118;quickSort
332500;110556250000;201428;6065016;6266444;5662160;0.027158;quickSort
332600;110622760000;201528;6067116;6268644;5664060;0.027202;quickSort
332700;110689290000;201628;6069216;6270844;5665960;0.027682;quickSort
332800;110755840000;201728;6071316;6273044;5667860;0.027141;quickSort
332900;110822410000;201828;6073416;6275244;5669760;0.027278;quickSort
333000;110889000000;201928;6075516;6277444;5671660;0.027372;quickSort
333100;110955610000;202028;6077616;6279644;5673560;0.027143;quickSort
333200;111022240000;202128;6079716;6281844;5675460;0.027176;quickSort
333300;111088890000;202228;6081816;6284044;5677360;0.027295;quickSort
333400;111155560000;202328;6083916;6286244;5679260;0.027209;quickSort
333500;111222250000;202428;6086016;6288444;5681160;0.027302;quickSort
333600;111288960000;202528;6088116;6290644;5683060;0.027288;quickSort
333700;111355690000;202628;6090216;6292844;5684960;0.027238;quickSort
333800;111422440000;202728;6092316;6295044;5686860;0.027301;quickSort
333900;111489210000;202828;6094416;6297244;5688760;0.027358;quickSort
334000;111556000000;202928;6096516;6299444;5690660;0.027311;quickSort
334100;111622810000;203028;6098616;6301644;5692560;0.027455;quickSort
334200;111689640000;203128;6100716;6303844;5694460;0.027466;quickSort
334300;111756490000;203228;6102816;6306044;5696360;0.027366;quickSort
334400;111823360000;203328;6104916;6308244;5698260;0.026706;quickSort
334500;111890250000;203428;6107016;6310444;5700160;0.027502;quickSort
334600;111957160000;203528;6109116;6312644;5702060;0.027460;quickSort
334700;112024090000;203628;6111216;6314844;5703960;0.027650;quickSort
334800;112091040000;203728;6113316;6317044;5705860;0.027367;quickSort
334900;112158010000;203828;6115416;6319244;5707760;0.027517;quickSort
335000;112225000000;203928;6117516;6321444;5709660;0.027448;quickSort
335100;112292010000;204028;6119616;6323644;5711560;0.027446;quickSort
335200;112359040000;204128;6121716;6325844;5713460;0.028771;quickSort
335300;112426090000;204228;6123816;6328044;5715360;0.027574;quickSort
335400;112493160000;204328;6125916;6330244;5717260;0.027577;quickSort
335500;112560250000;204428;6128016;6332444;5719160;0.028620;quickSort
335600;112627360000;204528;6130116;6334644;5721060;0.027928;quickSort
335700;112694490000;204628;6132216;6336844;5722960;0.027328;quickSort
335800;112761640000;204728;6134316;6339044;5724860;0.027574;quickSort
335900;112828810000;204828;6136416;6341244;5726760;0.027615;quickSort
336000;112896000000;204928;6138516;6343444;5728660;0.027592;quickSort
336100;112963210000;205028;6140616;6345644;5730560;0.027575;quickSort
336200;113030440000;205128;6142716;6347844;5732460;0.027619;quickSort
336300;113097690000;205228;6144816;6350044;5734360;0.028443;quickSort
336400;113164960000;205328;6146916;6352244;5736260;0.027782;quickSort
336500;113232250000;205428;6149016;6354444;5738160;0.028358;quickSort
336600;113299560000;205528;6151116;6356644;5740060;0.027698;quickSort
336700;113366890000;205628;6153216;6358844;5741960;0.027680;quickSort
336800;113434240000;205728;6155316;6361044;5743860;0.027910;quickSort
336900;113501610000;205828;6157416;6363244;5745760;0.027684;quickSort
337000;113569000000;205928;6159516;6365444;5747660;0.028145;quickSort
337100;113636410000;206028;6161616;6367644;5749560;0.028136;quickSort
337200;113703840000;206128;6163716;6369844;5751460;0.028231;quickSort
337300;113771290000;206228;6165816;6372044;5753360;0.027761;quickSort
337400;113838760000;206328;6167916;6374244;5755260;0.027650;quickSort
337500;113906250000;206428;6170016;6376444;5757160;0.028085;quickSort
337600;113973760000;206528;6172116;6378644;5759060;0.027953;quickSort
337700;114041290000;206628;6174216;6380844;5760960;0.027859;quickSort
337800;114108840000;206728;6176316;6383044;5762860;0.027805;quickSort
337900;114176410000;206828;6178416;6385244;5764760;0.027823;quickSort
338000;114244000000;206928;6180516;6387444;5766660;0.027942;quickSort
338100;114311610000;207028;6182616;6389644;5768560;0.027077;quickSort
338200;114379240000;207128;6184716;6391844;5770460;0.028018;quickSort
338300;114446890000;207228;6186816;6394044;5772360;0.027871;quickSort
338400;114514560000;207328;6188916;6396244;5774260;0.028363;quickSort
338500;114582250000;207428;6191016;6398444;5776160;0.028543;quickSort
338600;114649960000;207528;6193116;6400644;5778060;0.027838;quickSort
338700;114717690000;207628;6195216;6402844;5779960;0.027903;quickSort
338800;114785440000;207728;6197316;6405044;5781860;0.027920;quickSort
338900;114853210000;207828;6199416;6407244;5783760;0.027900;quickSort
339000;114921000000;207928;6201516;6409444;5785660;0.027886;quickSort
339100;114988810000;208028;6203616;6411644;5787560;0.029022;quickSort
339200;115056640000;208128;6205716;6413844;5789460;0.028331;quickSort
339300;115124490000;208228;6207816;6416044;5791360;0.028050;quickSort
339400;115192360000;208328;6209916;6418244;5793260;0.028063;quickSort
339500;115260250000;208428;6212016;6420444;5795160;0.029736;quickSort
339600;115328160000;208528;6214116;6422644;5797060;0.028081;quickSort
339700;115396090000;208628;6216216;6424844;5798960;0.027994;quickSort
339800;115464040000;208728;6218316;6427044;5800860;0.028063;quickSort
339900;115532010000;208828;6220416;6429244;5802760;0.028043;quickSort
340000;115600000000;208928;6222516;6431444;5804660;0.028019;quickSort
340100;115668010000;209028;6224616;6433644;5806560;0.028030;quickSort
340200;115736040000;209128;6226716;6435844;5808460;0.028041;quickSort
340300;115804090000;209228;6228816;6438044;5810360;0.028429;quickSort
340400;115872160000;209328;6230916;6440244;5812260;0.028264;quickSort
340500;115940250000;209428;6233016;6442444;5814160;0.028050;quickSort
340600;116008360000;209528;6235116;6444644;5816060;0.028139;quickSort
340700;116076490000;209628;6237216;6446844;5817960;0.028074;quickSort
340800;116144640000;209728;6239316;6449044;5819860;0.028120;quickSort
340900;116212810000;209828;6241416;6451244;5821760;0.028377;quickSort
341000;116281000000;209928;6243516;6453444;5823660;0.028336;quickSort
341100;116349210000;210028;6245616;6455644;5825560;0.028244;quickSort
341200;116417440000;210128;6247716;6457844;5827460;0.028101;quickSort
341300;116485690000;210228;6249816;6460044;5829360;0.028156;quickSort
341400;116553960000;210328;6251916;6462244;5831260;0.028169;quickSort
341500;116622250000;210428;6254016;6464444;5833160;0.028226;quickSort
341600;116690560000;210528;6256116;6466644;5835060;0.028169;quickSort
341700;116758890000;210628;6258216;6468844;5836960;0.028190;quickSort
341800;116827240000;210728;6260316;6471044;5838860;0.028247;quickSort
341900;116895610000;210828;6262416;6473244;5840760;0.028599;quickSort
342000;116964000000;210928;6264516;6475444;5842660;0.028521;quickSort
342100;117032410000;211028;6266616;6477644;5844560;0.029518;quickSort
342200;117100840000;211128;6268716;6479844;5846460;0.028184;quickSort
342300;117169290000;211228;6270816;6482044;5848360;0.029438;quickSort
342400;117237760000;211328;6272916;6484244;5850260;0.028368;quickSort
342500;117306250000;211428;6275016;6486444;5852160;0.028310;quickSort
342600;117374760000;211528;6277116;6488644;5854060;0.028278;quickSort
342700;117443290000;211628;6279216;6490844;5855960;0.028354;quickSort
342800;117511840000;211728;6281316;6493044;5857860;0.028322;quickSort
342900;117580410000;211828;6283416;6495244;5859760;0.028691;quickSort
343000;117649000000;211928;6285516;6497444;5861660;0.028388;quickSort
343100;117717610000;212028;6287616;6499644;5863560;0.027604;quickSort
343200;117786240000;212128;6289716;6501844;5865460;0.027590;quickSort
343300;117854890000;212228;6291816;6504044;5867360;0.028346;quickSort
343400;117923560000;212328;6293916;6506244;5869260;0.028348;quickSort
343500;117992250000;212428;6296016;6508444;5871160;0.028445;quickSort
343600;118060960000;212528;6298116;6510644;5873060;0.029569;quickSort
343700;118129690000;212628;6300216;6512844;5874960;0.028565;quickSort
343800;118198440000;212728;6302316;6515044;5876860;0.028396;quickSort
343900;118267210000;212828;6304416;6517244;5878760;0.030503;quickSort
344000;118336000000;212928;6306516;6519444;5880660;0.028414;quickSort
344100;118404810000;213028;6308616;6521644;5882560;0.030559;quickSort
344200;118473640000;213128;6310716;6523844;5884460;0.029158;quickSort
344300;118542490000;213228;6312816;6526044;5886360;0.028556;quickSort
344400;118611360000;213328;6314916;6528244;5888260;0.028550;quickSort
344500;118680250000;213428;6317016;6530444;5890160;0.028513;quickSort
344600;118749160000;213528;6319116;6532644;5892060;0.028853;quickSort
344700;118818090000;213628;6321216;6534844;5893960;0.028520;quickSort
344800;118887040000;213728;6323316;6537044;5895860;0.029124;quickSort
344900;118956010000;213828;6325416;6539244;5897760;0.028500;quickSort
345000;119025000000;213928;6327516;6541444;5899660;0.028543;quickSort
345100;119094010000;214028;6329616;6543644;5901560;0.028596;quickSort
345200;119163040000;214128;6331716;6545844;5903460;0.028587;quickSort
345300;119232090000;214228;6333816;6548044;5905360;0.029057;quickSort
345400;119301160000;214328;6335916;6550244;5907260;0.028577;quickSort
345500;119370250000;214428;6338016;6552444;5909160;0.029067;quickSort
345600;119439360000;214528;6340116;6554644;5911060;0.028802;quickSort
345700;119508490000;214628;6342216;6556844;5912960;0.029048;quickSort
345800;119577640000;214728;6344316;6559044;5914860;0.028624;quickSort
345900;119646810000;214828;6346416;6561244;5916760;0.028586;quickSort
346000;119716000000;214928;6348516;6563444;5918660;0.028707;quickSort
346100;119785210000;215028;6350616;6565644;5920560;0.028615;quickSort
346200;119854440000;215128;6352716;6567844;5922460;0.028720;quickSort
346300;119923690000;215228;6354816;6570044;5924360;0.028778;quickSort
346400;119992960000;215328;6356916;6572244;5926260;0.028642;quickSort
346500;120062250000;215428;6359016;6574444;5928160;0.028764;quickSort
346600;120131560000;215528;6361116;6576644;5930060;0.028649;quickSort
346700;120200890000;215628;6363216;6578844;5931960;0.028766;quickSort
346800;120270240000;215728;6365316;6581044;5933860;0.028791;quickSort
346900;120339610000;215828;6367416;6583244;5935760;0.028741;quickSort
347000;120409000000;215928;6369516;6585444;5937660;0.028752;quickSort
347100;120478410000;216028;6371616;6587644;5939560;0.029137;quickSort
347200;120547840000;216128;6373716;6589844;5941460;0.030053;quickSort
347300;120617290000;216228;6375816;6592044;5943360;0.028740;quickSort
347400;120686760000;216328;6377916;6594244;5945260;0.028781;quickSort
347500;120756250000;216428;6380016;6596444;5947160;0.028740;quickSort
347600;120825760000;216528;6382116;6598644;5949060;0.032000;quickSort
347700;120895290000;216628;6384216;6600844;5950960;0.028767;quickSort
347800;120964840000;216728;6386316;6603044;5952860;0.028921;quickSort
347900;121034410000;216828;6388416;6605244;5954760;0.028777;quickSort
348000;121104000000;216928;6390516;6607444;5956660;0.028838;quickSort
348100;121173610000;217028;6392616;6609644;5958560;0.028808;quickSort
348200;121243240000;217128;6394716;6611844;5960460;0.029132;quickSort
348300;121312890000;217228;6396816;6614044;5962360;0.029140;quickSort
348400;121382560000;217328;6398916;6616244;5964260;0.028961;quickSort
348500;121452250000;217428;6401016;6618444;5966160;0.030343;quickSort
348600;121521960000;217528;6403116;6620644;5968060;0.028893;quickSort
348700;121591690000;217628;6405216;6622844;5969960;0.029580;quickSort
348800;121661440000;217728;6407316;6625044;5971860;0.029104;quickSort
348900;121731210000;217828;6409416;6627244;5973760;0.029911;quickSort
349000;121801000000;217928;6411516;6629444;5975660;0.041429;quickSort
349100;121870810000;218028;6413616;6631644;5977560;0.033310;quickSort
349200;121940640000;218128;6415716;6633844;5979460;0.029101;quickSort
349300;122010490000;218228;6417816;6636044;5981360;0.029825;quickSort
349400;122080360000;218328;6419916;6638244;5983260;0.029184;quickSort
349500;122150250000;218428;6422016;6640444;5985160;0.029846;quickSort
349600;122220160000;218528;6424116;6642644;5987060;0.029994;quickSort
349700;122290090000;218628;6426216;6644844;5988960;0.029186;quickSort
349800;122360040000;218728;6428316;6647044;5990860;0.029240;quickSort
349900;122430010000;218828;6430416;6649244;5992760;0.029013;quickSort
350000;122500000000;218928;6432516;6651444;5994660;0.029012;quickSort
350100;122570010000;219028;6434616;6653644;5996560;0.029101;quickSort
350200;122640040000;219128;6436716;6655844;5998460;0.029056;quickSort
350300;122710090000;219228;6438816;6658044;6000360;0.029074;quickSort
350400;122780160000;219328;6440916;6660244;6002260;0.029168;quickSort
350500;122850250000;219428;6443016;6662444;6004160;0.029042;quickSort
350600;122920360000;219528;6445116;6664644;6006060;0.031259;quickSort
350700;122990490000;219628;6447216;6666844;6007960;0.029091;quickSort
350800;123060640000;219728;6449316;6669044;6009860;0.029186;quickSort
350900;123130810000;219828;6451416;6671244;6011760;0.030513;quickSort
351000;123201000000;219928;6453516;6673444;6013660;0.029866;quickSort
351100;123271210000;220028;6455616;6675644;6015560;0.029109;quickSort
351200;123341440000;220128;6457716;6677844;6017460;0.029212;quickSort
351300;123411690000;220228;6459816;6680044;6019360;0.029142;quickSort
351400;123481960000;220328;6461916;6682244;6021260;0.028743;quickSort
351500;123552250000;220428;6464016;6684444;6023160;0.028608;quickSort
351600;123622560000;220528;6466116;6686644;6025060;0.029119;quickSort
351700;123692890000;220628;6468216;6688844;6026960;0.029162;quickSort
351800;123763240000;220728;6470316;6691044;6028860;0.029181;quickSort
351900;123833610000;220828;6472416;6693244;6030760;0.031547;quickSort
352000;123904000000;220928;6474516;6695444;6032660;0.029463;quickSort
352100;123974410000;221028;6476616;6697644;6034560;0.029506;quickSort
352200;124044840000;221128;6478716;6699844;6036460;0.029398;quickSort
352300;124115290000;221228;6480816;6702044;6038360;0.029319;quickSort
352400;124185760000;221328;6482916;6704244;6040260;0.029274;quickSort
352500;124256250000;221428;6485016;6706444;6042160;0.029226;quickSort
352600;124326760000;221528;6487116;6708644;6044060;0.029275;quickSort
352700;124397290000;221628;6489216;6710844;6045960;0.029393;quickSort
352800;124467840000;221728;6491316;6713044;6047860;0.030100;quickSort
352900;124538410000;221828;6493416;6715244;6049760;0.029312;quickSort
353000;124609000000;221928;6495516;6717444;6051660;0.029281;quickSort
353100;124679610000;222028;6497616;6719644;6053560;0.029273;quickSort
353200;124750240000;222128;6499716;6721844;6055460;0.029295;quickSort
353300;124820890000;222228;6501816;6724044;6057360;0.029283;quickSort
353400;124891560000;222328;6503916;6726244;6059260;0.029413;quickSort
353500;124962250000;222428;6506016;6728444;6061160;0.029346;quickSort
353600;125032960000;222528;6508116;6730644;6063060;0.029327;quickSort
353700;125103690000;222628;6510216;6732844;6064960;0.029353;quickSort
353800;125174440000;222728;6512316;6735044;6066860;0.029345;quickSort
353900;125245210000;222828;6514416;6737244;6068760;0.029425;quickSort
354000;125316000000;222928;6516516;6739444;6070660;0.030069;quickSort
354100;125386810000;223028;6518616;6741644;6072560;0.029621;quickSort
354200;125457640000;223128;6520716;6743844;6074460;0.029361;quickSort
354300;125528490000;223228;6522816;6746044;6076360;0.029344;quickSort
354400;125599360000;223328;6524916;6748244;6078260;0.029464;quickSort
354500;125670250000;223428;6527016;6750444;6080160;0.029521;quickSort
354600;125741160000;223528;6529116;6752644;6082060;0.030210;quickSort
354700;125812090000;223628;6531216;6754844;6083960;0.029666;quickSort
354800;125883040000;223728;6533316;6757044;6085860;0.029499;quickSort
354900;125954010000;223828;6535416;6759244;6087760;0.029517;quickSort
355000;126025000000;223928;6537516;6761444;6089660;0.029453;quickSort
355100;126096010000;224028;6539616;6763644;6091560;0.029173;quickSort
355200;126167040000;224128;6541716;6765844;6093460;0.028757;quickSort
355300;126238090000;224228;6543816;6768044;6095360;0.029249;quickSort
355400;126309160000;224328;6545916;6770244;6097260;0.029578;quickSort
355500;126380250000;224428;6548016;6772444;6099160;0.029472;quickSort
355600;126451360000;224528;6550116;6774644;6101060;0.029558;quickSort
355700;126522490000;224628;6552216;6776844;6102960;0.029514;quickSort
355800;126593640000;224728;6554316;6779044;6104860;0.029507;quickSort
355900;126664810000;224828;6556416;6781244;6106760;0.029512;quickSort
356000;126736000000;224928;6558516;6783444;6108660;0.029646;quickSort
356100;126807210000;225028;6560616;6785644;6110560;0.030309;quickSort
356200;126878440000;225128;6562716;6787844;6112460;0.029606;quickSort
356300;126949690000;225228;6564816;6790044;6114360;0.029583;quickSort
356400;127020960000;225328;6566916;6792244;6116260;0.029963;quickSort
356500;127092250000;225428;6569016;6794444;6118160;0.029589;quickSort
356600;127163560000;225528;6571116;6796644;6120060;0.029722;quickSort
356700;127234890000;225628;6573216;6798844;6121960;0.029958;quickSort
356800;127306240000;225728;6575316;6801044;6123860;0.030665;quickSort
356900;127377610000;225828;6577416;6803244;6125760;0.029718;quickSort
357000;127449000000;225928;6579516;6805444;6127660;0.029713;quickSort
357100;127520410000;226028;6581616;6807644;6129560;0.029716;quickSort
357200;127591840000;226128;6583716;6809844;6131460;0.029779;quickSort
357300;127663290000;226228;6585816;6812044;6133360;0.029744;quickSort
357400;127734760000;226328;6587916;6814244;6135260;0.029827;quickSort
357500;127806250000;226428;6590016;6816444;6137160;0.029090;quickSort
357600;127877760000;226528;6592116;6818644;6139060;0.029071;quickSort
357700;127949290000;226628;6594216;6820844;6140960;0.029713;quickSort
357800;128020840000;226728;6596316;6823044;6142860;0.030341;quickSort
357900;128092410000;226828;6598416;6825244;6144760;0.030741;quickSort
358000;128164000000;226928;6600516;6827444;6146660;0.030741;quickSort
358100;128235610000;227028;6602616;6829644;6148560;0.030681;quickSort
358200;128307240000;227128;6604716;6831844;6150460;0.030148;quickSort
358300;128378890000;227228;6606816;6834044;6152360;0.029727;quickSort
358400;128450560000;227328;6608916;6836244;6154260;0.029759;quickSort
358500;128522250000;227428;6611016;6838444;6156160;0.029821;quickSort
358600;128593960000;227528;6613116;6840644;6158060;0.029351;quickSort
358700;128665690000;227628;6615216;6842844;6159960;0.029748;quickSort
358800;128737440000;227728;6617316;6845044;6161860;0.029753;quickSort
358900;128809210000;227828;6619416;6847244;6163760;0.029783;quickSort
359000;128881000000;227928;6621516;6849444;6165660;0.029808;quickSort
359100;128952810000;228028;6623616;6851644;6167560;0.029774;quickSort
359200;129024640000;228128;6625716;6853844;6169460;0.029852;quickSort
359300;129096490000;228228;6627816;6856044;6171360;0.029833;quickSort
359400;129168360000;228328;6629916;6858244;6173260;0.029782;quickSort
359500;129240250000;228428;6632016;6860444;6175160;0.029846;quickSort
359600;129312160000;228528;6634116;6862644;6177060;0.030185;quickSort
359700;129384090000;228628;6636216;6864844;6178960;0.030025;quickSort
359800;129456040000;228728;6638316;6867044;6180860;0.032069;quickSort
359900;129528010000;228828;6640416;6869244;6182760;0.031161;quickSort
360000;129600000000;228928;6642516;6871444;6184660;0.029989;quickSort
360100;129672010000;229028;6644616;6873644;6186560;0.030046;quickSort
360200;129744040000;229128;6646716;6875844;6188460;0.029847;quickSort
360300;129816090000;229228;6648816;6878044;6190360;0.029888;quickSort
360400;129888160000;229328;6650916;6880244;6192260;0.029881;quickSort
360500;129960250000;229428;6653016;6882444;6194160;0.029957;quickSort
360600;130032360000;229528;6655116;6884644;6196060;0.029924;quickSort
360700;130104490000;229628;6657216;6886844;6197960;0.029996;quickSort
360800;130176640000;229728;6659316;6889044;6199860;0.029923;quickSort
360900;130248810000;229828;6661416;6891244;6201760;0.029934;quickSort
361000;130321000000;229928;6663516;6893444;6203660;0.029954;quickSort
361100;130393210000;230028;6665616;6895644;6205560;0.030047;quickSort
361200;130465440000;230128;6667716;6897844;6207460;0.030648;quickSort
361300;130537690000;230228;6669816;6900044;6209360;0.032060;quickSort
361400;130609960000;230328;6671916;6902244;6211260;0.030069;quickSort
361500;130682250000;230428;6674016;6904444;6213160;0.030650;quickSort
361600;130754560000;230528;6676116;6906644;6215060;0.030406;quickSort
361700;130826890000;230628;6678216;6908844;6216960;0.030037;quickSort
361800;130899240000;230728;6680316;6911044;6218860;0.029351;quickSort
361900;130971610000;230828;6682416;6913244;6220760;0.029334;quickSort
362000;131044000000;230928;6684516;6915444;6222660;0.030078;quickSort
362100;131116410000;231028;6686616;6917644;6224560;0.030680;quickSort
362200;131188840000;231128;6688716;6919844;6226460;0.029354;quickSort
362300;131261290000;231228;6690816;6922044;6228360;0.029367;quickSort
362400;131333760000;231328;6692916;6924244;6230260;0.030239;quickSort
362500;131406250000;231428;6695016;6926444;6232160;0.031136;quickSort
362600;131478760000;231528;6697116;6928644;6234060;0.030295;quickSort
362700;131551290000;231628;6699216;6930844;6235960;0.030265;quickSort
362800;131623840000;231728;6701316;6933044;6237860;0.030464;quickSort
362900;131696410000;231828;6703416;6935244;6239760;0.030276;quickSort
363000;131769000000;231928;6705516;6937444;6241660;0.030707;quickSort
363100;131841610000;232028;6707616;6939644;6243560;0.030335;quickSort
363200;131914240000;232128;6709716;6941844;6245460;0.030207;quickSort
363300;131986890000;232228;6711816;6944044;6247360;0.032801;quickSort
363400;132059560000;232328;6713916;6946244;6249260;0.030204;quickSort
363500;132132250000;232428;6716016;6948444;6251160;0.030993;quickSort
363600;132204960000;232528;6718116;6950644;6253060;0.030291;quickSort
363700;132277690000;232628;6720216;6952844;6254960;0.030712;quickSort
363800;132350440000;232728;6722316;6955044;6256860;0.030302;quickSort
363900;132423210000;232828;6724416;6957244;6258760;0.030376;quickSort
364000;132496000000;232928;6726516;6959444;6260660;0.030273;quickSort
364100;132568810000;233028;6728616;6961644;6262560;0.030314;quickSort
364200;132641640000;233128;6730716;6963844;6264460;0.030312;quickSort
364300;132714490000;233228;6732816;6966044;6266360;0.030398;quickSort
364400;132787360000;233328;6734916;6968244;6268260;0.030311;quickSort
364500;132860250000;233428;6737016;6970444;6270160;0.030322;quickSort
364600;132933160000;233528;6739116;6972644;6272060;0.030342;quickSort
364700;133006090000;233628;6741216;6974844;6273960;0.032204;quickSort
364800;133079040000;233728;6743316;6977044;6275860;0.030329;quickSort
364900;133152010000;233828;6745416;6979244;6277760;0.030528;quickSort
365000;133225000000;233928;6747516;6981444;6279660;0.030423;quickSort
365100;133298010000;234028;6749616;6983644;6281560;0.030964;quickSort
365200;133371040000;234128;6751716;6985844;6283460;0.030465;quickSort
365300;133444090000;234228;6753816;6988044;6285360;0.030393;quickSort
365400;133517160000;234328;6755916;6990244;6287260;0.030430;quickSort
365500;133590250000;234428;6758016;6992444;6289160;0.030416;quickSort
365600;133663360000;234528;6760116;6994644;6291060;0.030562;quickSort
365700;133736490000;234628;6762216;6996844;6292960;0.030455;quickSort
365800;133809640000;234728;6764316;6999044;6294860;0.030509;quickSort
365900;133882810000;234828;6766416;7001244;6296760;0.030461;quickSort
366000;133956000000;234928;6768516;7003444;6298660;0.030422;quickSort
366100;134029210000;235028;6770616;7005644;6300560;0.031948;quickSort
366200;134102440000;235128;6772716;7007844;6302460;0.030671;quickSort
366300;134175690000;235228;6774816;7010044;6304360;0.030541;quickSort
366400;134248960000;235328;6776916;7012244;6306260;0.030528;quickSort
366500;134322250000;235428;6779016;7014444;6308160;0.030536;quickSort
366600;134395560000;235528;6781116;7016644;6310060;0.030517;quickSort
366700;134468890000;235628;6783216;7018844;6311960;0.031204;quickSort
366800;134542240000;235728;6785316;7021044;6313860;0.030684;quickSort
366900;134615610000;235828;6787416;7023244;6315760;0.030651;quickSort
367000;134689000000;235928;6789516;7025444;6317660;0.030546;quickSort
367100;134762410000;236028;6791616;7027644;6319560;0.030585;quickSort
367200;134835840000;236128;6793716;7029844;6321460;0.030633;quickSort
367300;134909290000;236228;6795816;7032044;6323360;0.030571;quickSort
367400;134982760000;236328;6797916;7034244;6325260;0.030627;quickSort
367500;135056250000;236428;6800016;7036444;6327160;0.030794;quickSort
367600;135129760000;236528;6802116;7038644;6329060;0.030654;quickSort
367700;135203290000;236628;6804216;7040844;6330960;0.029909;quickSort
367800;135276840000;236728;6806316;7043044;6332860;0.030662;quickSort
367900;135350410000;236828;6808416;7045244;6334760;0.030753;quickSort
368000;135424000000;236928;6810516;7047444;6336660;0.030747;quickSort
368100;135497610000;237028;6812616;7049644;6338560;0.030695;quickSort
368200;135571240000;237128;6814716;7051844;6340460;0.030711;quickSort
368300;135644890000;237228;6816816;7054044;6342360;0.030736;quickSort
368400;135718560000;237328;6818916;7056244;6344260;0.030732;quickSort
368500;135792250000;237428;6821016;7058444;6346160;0.030697;quickSort
368600;135865960000;237528;6823116;7060644;6348060;0.030750;quickSort
368700;135939690000;237628;6825216;7062844;6349960;0.030737;quickSort
368800;136013440000;237728;6827316;7065044;6351860;0.031260;quickSort
368900;136087210000;237828;6829416;7067244;6353760;0.030852;quickSort
369000;136161000000;237928;6831516;7069444;6355660;0.031107;quickSort
369100;136234810000;238028;6833616;7071644;6357560;0.030796;quickSort
369200;136308640000;238128;6835716;7073844;6359460;0.031544;quickSort
369300;136382490000;238228;6837816;7076044;6361360;0.030828;quickSort
369400;136456360000;238328;6839916;7078244;6363260;0.031509;quickSort
369500;136530250000;238428;6842016;7080444;6365160;0.031322;quickSort
369600;136604160000;238528;6844116;7082644;6367060;0.030823;quickSort
369700;136678090000;238628;6846216;7084844;6368960;0.030872;quickSort
369800;136752040000;238728;6848316;7087044;6370860;0.030873;quickSort
369900;136826010000;238828;6850416;7089244;6372760;0.030892;quickSort
370000;136900000000;238928;6852516;7091444;6374660;0.030872;quickSort
370100;136974010000;239028;6854616;7093644;6376560;0.030886;quickSort
370200;137048040000;239128;6856716;7095844;6378460;0.031041;quickSort
370300;137122090000;239228;6858816;7098044;6380360;0.030961;quickSort
370400;137196160000;239328;6860916;7100244;6382260;0.030901;quickSort
370500;137270250000;239428;6863016;7102444;6384160;0.031009;quickSort
370600;137344360000;239528;6865116;7104644;6386060;0.030958;quickSort
370700;137418490000;239628;6867216;7106844;6387960;0.032350;quickSort
370800;137492640000;239728;6869316;7109044;6389860;0.033228;quickSort
370900;137566810000;239828;6871416;7111244;6391760;0.030956;quickSort
371000;137641000000;239928;6873516;7113444;6393660;0.030971;quickSort
371100;137715210000;240028;6875616;7115644;6395560;0.030969;quickSort
371200;137789440000;240128;6877716;7117844;6397460;0.031040;quickSort
371300;137863690000;240228;6879816;7120044;6399360;0.031062;quickSort
371400;137937960000;240328;6881916;7122244;6401260;0.030973;quickSort
371500;138012250000;240428;6884016;7124444;6403160;0.030999;quickSort
371600;138086560000;240528;6886116;7126644;6405060;0.031054;quickSort
371700;138160890000;240628;6888216;7128844;6406960;0.031134;quickSort
371800;138235240000;240728;6890316;7131044;6408860;0.031035;quickSort
371900;138309610000;240828;6892416;7133244;6410760;0.031116;quickSort
372000;138384000000;240928;6894516;7135444;6412660;0.031053;quickSort
372100;138458410000;241028;6896616;7137644;6414560;0.031173;quickSort
372200;138532840000;241128;6898716;7139844;6416460;0.031075;quickSort
372300;138607290000;241228;6900816;7142044;6418360;0.031113;quickSort
372400;138681760000;241328;6902916;7144244;6420260;0.031108;quickSort
372500;138756250000;241428;6905016;7146444;6422160;0.031285;quickSort
372600;138830760000;241528;6907116;7148644;6424060;0.031407;quickSort
372700;138905290000;241628;6909216;7150844;6425960;0.031480;quickSort
372800;138979840000;241728;6911316;7153044;6427860;0.032395;quickSort
372900;139054410000;241828;6913416;7155244;6429760;0.032098;quickSort
373000;139129000000;241928;6915516;7157444;6431660;0.032506;quickSort
373100;139203610000;242028;6917616;7159644;6433560;0.032270;quickSort
373200;139278240000;242128;6919716;7161844;6435460;0.032609;quickSort
373300;139352890000;242228;6921816;7164044;6437360;0.031197;quickSort
373400;139427560000;242328;6923916;7166244;6439260;0.031248;quickSort
373500;139502250000;242428;6926016;7168444;6441160;0.031845;quickSort
373600;139576960000;242528;6928116;7170644;6443060;0.032772;quickSort
373700;139651690000;242628;6930216;7172844;6444960;0.032094;quickSort
373800;139726440000;242728;6932316;7175044;6446860;0.031228;quickSort
373900;139801210000;242828;6934416;7177244;6448760;0.031207;quickSort
374000;139876000000;242928;6936516;7179444;6450660;0.031204;quickSort
374100;139950810000;243028;6938616;7181644;6452560;0.031293;quickSort
374200;140025640000;243128;6940716;7183844;6454460;0.031262;quickSort
374300;140100490000;243228;6942816;7186044;6456360;0.031361;quickSort
374400;140175360000;243328;6944916;7188244;6458260;0.032037;quickSort
374500;140250250000;243428;6947016;7190444;6460160;0.031293;quickSort
374600;140325160000;243528;6949116;7192644;6462060;0.031033;quickSort
374700;140400090000;243628;6951216;7194844;6463960;0.031238;quickSort
374800;140475040000;243728;6953316;7197044;6465860;0.031463;quickSort
374900;140550010000;243828;6955416;7199244;6467760;0.031380;quickSort
375000;140625000000;243928;6957516;7201444;6469660;0.031411;quickSort
375100;140700010000;244028;6959616;7203644;6471560;0.031459;quickSort
375200;140775040000;244128;6961716;7205844;6473460;0.031333;quickSort
375300;140850090000;244228;6963816;7208044;6475360;0.031721;quickSort
375400;140925160000;244328;6965916;7210244;6477260;0.031393;quickSort
375500;141000250000;244428;6968016;7212444;6479160;0.031430;quickSort
375600;141075360000;244528;6970116;7214644;6481060;0.031496;quickSort
375700;141150490000;244628;6972216;7216844;6482960;0.030764;quickSort
375800;141225640000;244728;6974316;7219044;6484860;0.031041;quickSort
375900;141300810000;244828;6976416;7221244;6486760;0.031451;quickSort
376000;141376000000;244928;6978516;7223444;6488660;0.031682;quickSort
376100;141451210000;245028;6980616;7225644;6490560;0.031496;quickSort
376200;141526440000;245128;6982716;7227844;6492460;0.031621;quickSort
376300;141601690000;245228;6984816;7230044;6494360;0.034987;quickSort
376400;141676960000;245328;6986916;7232244;6496260;0.033419;quickSort
376500;141752250000;245428;6989016;7234444;6498160;0.030949;quickSort
376600;141827560000;245528;6991116;7236644;6500060;0.032181;quickSort
376700;141902890000;245628;6993216;7238844;6501960;0.032184;quickSort
376800;141978240000;245728;6995316;7241044;6503860;0.032794;quickSort
376900;142053610000;245828;6997416;7243244;6505760;0.031631;quickSort
377000;142129000000;245928;6999516;7245444;6507660;0.031590;quickSort
377100;142204410000;246028;7001616;7247644;6509560;0.031556;quickSort
377200;142279840000;246128;7003716;7249844;6511460;0.031623;quickSort
377300;142355290000;246228;7005816;7252044;6513360;0.031582;quickSort
377400;142430760000;246328;7007916;7254244;6515260;0.031651;quickSort
377500;142506250000;246428;7010016;7256444;6517160;0.031720;quickSort
377600;142581760000;246528;7012116;7258644;6519060;0.033286;quickSort
377700;142657290000;246628;7014216;7260844;6520960;0.031697;quickSort
377800;142732840000;246728;7016316;7263044;6522860;0.031689;quickSort
377900;142808410000;246828;7018416;7265244;6524760;0.031680;quickSort
378000;142884000000;246928;7020516;7267444;6526660;0.031651;quickSort
378100;142959610000;247028;7022616;7269644;6528560;0.035554;quickSort
378200;143035240000;247128;7024716;7271844;6530460;0.031274;quickSort
378300;143110890000;247228;7026816;7274044;6532360;0.031735;quickSort
378400;143186560000;247328;7028916;7276244;6534260;0.031774;quickSort
378500;143262250000;247428;7031016;7278444;6536160;0.031823;quickSort
378600;143337960000;247528;7033116;7280644;6538060;0.032687;quickSort
378700;143413690000;247628;7035216;7282844;6539960;0.032101;quickSort
378800;143489440000;247728;7037316;7285044;6541860;0.032451;quickSort
378900;143565210000;247828;7039416;7287244;6543760;0.033555;quickSort
379000;143641000000;247928;7041516;7289444;6545660;0.031811;quickSort
379100;143716810000;248028;7043616;7291644;6547560;0.031767;quickSort
379200;143792640000;248128;7045716;7293844;6549460;0.032937;quickSort
379300;143868490000;248228;7047816;7296044;6551360;0.033427;quickSort
379400;143944360000;248328;7049916;7298244;6553260;0.031846;quickSort
379500;144020250000;248428;7052016;7300444;6555160;0.031808;quickSort
379600;144096160000;248528;7054116;7302644;6557060;0.031909;quickSort
379700;144172090000;248628;7056216;7304844;6558960;0.034762;quickSort
379800;144248040000;248728;7058316;7307044;6560860;0.032238;quickSort
379900;144324010000;248828;7060416;7309244;6562760;0.032457;quickSort
380000;144400000000;248928;7062516;7311444;6564660;0.031843;quickSort
380100;144476010000;249028;7064616;7313644;6566560;0.032002;quickSort
380200;144552040000;249128;7066716;7315844;6568460;0.031908;quickSort
380300;144628090000;249228;7068816;7318044;6570360;0.031865;quickSort
380400;144704160000;249328;7070916;7320244;6572260;0.032474;quickSort
380500;144780250000;249428;7073016;7322444;6574160;0.032011;quickSort
380600;144856360000;249528;7075116;7324644;6576060;0.032073;quickSort
380700;144932490000;249628;7077216;7326844;6577960;0.031999;quickSort
380800;145008640000;249728;7079316;7329044;6579860;0.031998;quickSort
380900;145084810000;249828;7081416;7331244;6581760;0.032614;quickSort
381000;145161000000;249928;7083516;7333444;6583660;0.032174;quickSort
381100;145237210000;250028;7085616;7335644;6585560;0.032718;quickSort
381200;145313440000;250128;7087716;7337844;6587460;0.032010;quickSort
381300;145389690000;250228;7089816;7340044;6589360;0.031210;quickSort
381400;145465960000;250328;7091916;7342244;6591260;0.031989;quickSort
381500;145542250000;250428;7094016;7344444;6593160;0.032024;quickSort
381600;145618560000;250528;7096116;7346644;6595060;0.032350;quickSort
381700;145694890000;250628;7098216;7348844;6596960;0.032149;quickSort
381800;145771240000;250728;7100316;7351044;6598860;0.032028;quickSort
381900;145847610000;250828;7102416;7353244;6600760;0.032412;quickSort
382000;145924000000;250928;7104516;7355444;6602660;0.032394;quickSort
382100;146000410000;251028;7106616;7357644;6604560;0.032378;quickSort
382200;146076840000;251128;7108716;7359844;6606460;0.032253;quickSort
382300;146153290000;251228;7110816;7362044;6608360;0.032920;quickSort
382400;146229760000;251328;7112916;7364244;6610260;0.032007;quickSort
382500;146306250000;251428;7115016;7366444;6612160;0.032825;quickSort
382600;146382760000;251528;7117116;7368644;6614060;0.032283;quickSort
382700;146459290000;251628;7119216;7370844;6615960;0.035604;quickSort
382800;146535840000;251728;7121316;7373044;6617860;0.032947;quickSort
382900;146612410000;251828;7123416;7375244;6619760;0.031747;quickSort
383000;146689000000;251928;7125516;7377444;6621660;0.032445;quickSort
383100;146765610000;252028;7127616;7379644;6623560;0.032142;quickSort
383200;146842240000;252128;7129716;7381844;6625460;0.032321;quickSort
383300;146918890000;252228;7131816;7384044;6627360;0.031384;quickSort
383400;146995560000;252328;7133916;7386244;6629260;0.032768;quickSort
383500;147072250000;252428;7136016;7388444;6631160;0.033457;quickSort
383600;147148960000;252528;7138116;7390644;6633060;0.032250;quickSort
383700;147225690000;252628;7140216;7392844;6634960;0.032600;quickSort
383800;147302440000;252728;7142316;7395044;6636860;0.032294;quickSort
383900;147379210000;252828;7144416;7397244;6638760;0.034559;quickSort
384000;147456000000;252928;7146516;7399444;6640660;0.032292;quickSort
384100;147532810000;253028;7148616;7401644;6642560;0.032393;quickSort
384200;147609640000;253128;7150716;7403844;6644460;0.032246;quickSort
384300;147686490000;253228;7152816;7406044;6646360;0.032664;quickSort
384400;147763360000;253328;7154916;7408244;6648260;0.032307;quickSort
384500;147840250000;253428;7157016;7410444;6650160;0.032353;quickSort
384600;147917160000;253528;7159116;7412644;6652060;0.032385;quickSort
384700;147994090000;253628;7161216;7414844;6653960;0.032404;quickSort
384800;148071040000;253728;7163316;7417044;6655860;0.032351;quickSort
384900;148148010000;253828;7165416;7419244;6657760;0.032346;quickSort
385000;148225000000;253928;7167516;7421444;6659660;0.032992;quickSort
385100;148302010000;254028;7169616;7423644;6661560;0.032446;quickSort
385200;148379040000;254128;7171716;7425844;6663460;0.032343;quickSort
385300;148456090000;254228;7173816;7428044;6665360;0.032332;quickSort
385400;148533160000;254328;7175916;7430244;6667260;0.032433;quickSort
385500;148610250000;254428;7178016;7432444;6669160;0.032633;quickSort
385600;148687360000;254528;7180116;7434644;6671060;0.033021;quickSort
385700;148764490000;254628;7182216;7436844;6672960;0.032497;quickSort
385800;148841640000;254728;7184316;7439044;6674860;0.032504;quickSort
385900;148918810000;254828;7186416;7441244;6676760;0.032523;quickSort
386000;148996000000;254928;7188516;7443444;6678660;0.032817;quickSort
386100;149073210000;255028;7190616;7445644;6680560;0.032513;quickSort
386200;149150440000;255128;7192716;7447844;6682460;0.032625;quickSort
386300;149227690000;255228;7194816;7450044;6684360;0.032607;quickSort
386400;149304960000;255328;7196916;7452244;6686260;0.032518;quickSort
386500;149382250000;255428;7199016;7454444;6688160;0.032646;quickSort
386600;149459560000;255528;7201116;7456644;6690060;0.032980;quickSort
386700;149536890000;255628;7203216;7458844;6691960;0.032714;quickSort
386800;149614240000;255728;7205316;7461044;6693860;0.033813;quickSort
386900;149691610000;255828;7207416;7463244;6695760;0.032710;quickSort
387000;149769000000;255928;7209516;7465444;6697660;0.032642;quickSort
387100;149846410000;256028;7211616;7467644;6699560;0.032567;quickSort
387200;149923840000;256128;7213716;7469844;6701460;0.032615;quickSort
387300;150001290000;256228;7215816;7472044;6703360;0.033243;quickSort
387400;150078760000;256328;7217916;7474244;6705260;0.033129;quickSort
387500;150156250000;256428;7220016;7476444;6707160;0.033035;quickSort
387600;150233760000;256528;7222116;7478644;6709060;0.032691;quickSort
387700;150311290000;256628;7224216;7480844;6710960;0.032851;quickSort
387800;150388840000;256728;7226316;7483044;6712860;0.032625;quickSort
387900;150466410000;256828;7228416;7485244;6714760;0.032723;quickSort
388000;150544000000;256928;7230516;7487444;6716660;0.033623;quickSort
388100;150621610000;257028;7232616;7489644;6718560;0.032641;quickSort
388200;150699240000;257128;7234716;7491844;6720460;0.033026;quickSort
388300;150776890000;257228;7236816;7494044;6722360;0.032870;quickSort
388400;150854560000;257328;7238916;7496244;6724260;0.032711;quickSort
388500;150932250000;257428;7241016;7498444;6726160;0.032894;quickSort
388600;151009960000;257528;7243116;7500644;6728060;0.032766;quickSort
388700;151087690000;257628;7245216;7502844;6729960;0.032701;quickSort
388800;151165440000;257728;7247316;7505044;6731860;0.032810;quickSort
388900;151243210000;257828;7249416;7507244;6733760;0.032778;quickSort
389000;151321000000;257928;7251516;7509444;6735660;0.032988;quickSort
389100;151398810000;258028;7253616;7511644;6737560;0.032848;quickSort
389200;151476640000;258128;7255716;7513844;6739460;0.032837;quickSort
389300;151554490000;258228;7257816;7516044;6741360;0.032804;quickSort
389400;151632360000;258328;7259916;7518244;6743260;0.032815;quickSort
389500;151710250000;258428;7262016;7520444;6745160;0.032804;quickSort
389600;151788160000;258528;7264116;7522644;6747060;0.032817;quickSort
389700;151866090000;258628;7266216;7524844;6748960;0.032969;quickSort
389800;151944040000;258728;7268316;7527044;6750860;0.032989;quickSort
389900;152022010000;258828;7270416;7529244;6752760;0.032813;quickSort
390000;152100000000;258928;7272516;7531444;6754660;0.032871;quickSort
390100;152178010000;259028;7274616;7533644;6756560;0.032802;quickSort
390200;152256040000;259128;7276716;7535844;6758460;0.032856;quickSort
390300;152334090000;259228;7278816;7538044;6760360;0.033570;quickSort
390400;152412160000;259328;7280916;7540244;6762260;0.032980;quickSort
390500;152490250000;259428;7283016;7542444;6764160;0.032929;quickSort
390600;152568360000;259528;7285116;7544644;6766060;0.032900;quickSort
390700;152646490000;259628;7287216;7546844;6767960;0.034972;quickSort
390800;152724640000;259728;7289316;7549044;6769860;0.033244;quickSort
390900;152802810000;259828;7291416;7551244;6771760;0.033034;quickSort
391000;152881000000;259928;7293516;7553444;6773660;0.032960;quickSort
391100;152959210000;260028;7295616;7555644;6775560;0.032960;quickSort
391200;153037440000;260128;7297716;7557844;6777460;0.032978;quickSort
391300;153115690000;260228;7299816;7560044;6779360;0.032957;quickSort
391400;153193960000;260328;7301916;7562244;6781260;0.033011;quickSort
391500;153272250000;260428;7304016;7564444;6783160;0.033035;quickSort
391600;153350560000;260528;7306116;7566644;6785060;0.033004;quickSort
391700;153428890000;260628;7308216;7568844;6786960;0.033004;quickSort
391800;153507240000;260728;7310316;7571044;6788860;0.033000;quickSort
391900;153585610000;260828;7312416;7573244;6790760;0.033050;quickSort
392000;153664000000;260928;7314516;7575444;6792660;0.033053;quickSort
392100;153742410000;261028;7316616;7577644;6794560;0.034625;quickSort
392200;153820840000;261128;7318716;7579844;6796460;0.032639;quickSort
392300;153899290000;261228;7320816;7582044;6798360;0.034660;quickSort
392400;153977760000;261328;7322916;7584244;6800260;0.033514;quickSort
392500;154056250000;261428;7325016;7586444;6802160;0.033104;quickSort
392600;154134760000;261528;7327116;7588644;6804060;0.033559;quickSort
392700;154213290000;261628;7329216;7590844;6805960;0.033506;quickSort
392800;154291840000;261728;7331316;7593044;6807860;0.033901;quickSort
392900;154370410000;261828;7333416;7595244;6809760;0.033193;quickSort
393000;154449000000;261928;7335516;7597444;6811660;0.033147;quickSort
393100;154527610000;262028;7337616;7599644;6813560;0.033216;quickSort
393200;154606240000;262128;7339716;7601844;6815460;0.033357;quickSort
393300;154684890000;262143;7341561;7603704;6817275;0.033267;quickSort
393400;154763560000;262143;7343361;7605504;6819075;0.033211;quickSort
393500;154842250000;262143;7345161;7607304;6820875;0.033166;quickSort
393600;154920960000;262143;7346961;7609104;6822675;0.033245;quickSort
393700;154999690000;262143;7348761;7610904;6824475;0.033226;quickSort
393800;155078440000;262143;7350561;7612704;6826275;0.034009;quickSort
393900;155157210000;262143;7352361;7614504;6828075;0.033205;quickSort
394000;155236000000;262143;7354161;7616304;6829875;0.033294;quickSort
394100;155314810000;262143;7355961;7618104;6831675;0.033260;quickSort
394200;155393640000;262143;7357761;7619904;6833475;0.033209;quickSort
394300;155472490000;262143;7359561;7621704;6835275;0.033244;quickSort
394400;155551360000;262143;7361361;7623504;6837075;0.033300;quickSort
394500;155630250000;262143;7363161;7625304;6838875;0.033290;quickSort
394600;155709160000;262143;7364961;7627104;6840675;0.033347;quickSort
394700;155788090000;262143;7366761;7628904;6842475;0.033342;quickSort
394800;155867040000;262143;7368561;7630704;6844275;0.033309;quickSort
394900;155946010000;262143;7370361;7632504;6846075;0.033316;quickSort
395000;156025000000;262143;7372161;7634304;6847875;0.035807;quickSort
395100;156104010000;262143;7373961;7636104;6849675;0.032849;quickSort
395200;156183040000;262143;7375761;7637904;6851475;0.033731;quickSort
395300;156262090000;262143;7377561;7639704;6853275;0.033389;quickSort
395400;156341160000;262143;7379361;7641504;6855075;0.033549;quickSort
395500;156420250000;262143;7381161;7643304;6856875;0.033392;quickSort
395600;156499360000;262143;7382961;7645104;6858675;0.034191;quickSort
395700;156578490000;262143;7384761;7646904;6860475;0.033397;quickSort
395800;156657640000;262143;7386561;7648704;6862275;0.033398;quickSort
395900;156736810000;262143;7388361;7650504;6864075;0.033414;quickSort
396000;156816000000;262143;7390161;7652304;6865875;0.033439;quickSort
396100;156895210000;262143;7391961;7654104;6867675;0.033587;quickSort
396200;156974440000;262143;7393761;7655904;6869475;0.033521;quickSort
396300;157053690000;262143;7395561;7657704;6871275;0.033481;quickSort
396400;157132960000;262143;7397361;7659504;6873075;0.033479;quickSort
396500;157212250000;262143;7399161;7661304;6874875;0.033413;quickSort
396600;157291560000;262143;7400961;7663104;6876675;0.033491;quickSort
396700;157370890000;262143;7402761;7664904;6878475;0.033508;quickSort
396800;157450240000;262143;7404561;7666704;6880275;0.033868;quickSort
396900;157529610000;262143;7406361;7668504;6882075;0.033901;quickSort
397000;157609000000;262143;7408161;7670304;6883875;0.034010;quickSort
397100;157688410000;262143;7409961;7672104;6885675;0.033541;quickSort
397200;157767840000;262143;7411761;7673904;6887475;0.033531;quickSort
397300;157847290000;262143;7413561;7675704;6889275;0.033599;quickSort
397400;157926760000;262143;7415361;7677504;6891075;0.035271;quickSort
397500;158006250000;262143;7417161;7679304;6892875;0.033605;quickSort
397600;158085760000;262143;7418961;7681104;6894675;0.033619;quickSort
397700;158165290000;262143;7420761;7682904;6896475;0.033574;quickSort
397800;158244840000;262143;7422561;7684704;6898275;0.033545;quickSort
397900;158324410000;262143;7424361;7686504;6900075;0.033668;quickSort
398000;158404000000;262143;7426161;7688304;6901875;0.034090;quickSort
398100;158483610000;262143;7427961;7690104;6903675;0.033934;quickSort
398200;158563240000;262143;7429761;7691904;6905475;0.035059;quickSort
398300;158642890000;262143;7431561;7693704;6907275;0.033782;quickSort
398400;158722560000;262143;7433361;7695504;6909075;0.034597;quickSort
398500;158802250000;262143;7435161;7697304;6910875;0.034112;quickSort
398600;158881960000;262143;7436961;7699104;6912675;0.033988;quickSort
398700;158961690000;262143;7438761;7700904;6914475;0.033753;quickSort
398800;159041440000;262143;7440561;7702704;6916275;0.034186;quickSort
398900;159121210000;262143;7442361;7704504;6918075;0.034846;quickSort
399000;159201000000;262143;7444161;7706304;6919875;0.033725;quickSort
399100;159280810000;262143;7445961;7708104;6921675;0.035735;quickSort
399200;159360640000;262143;7447761;7709904;6923475;0.033769;quickSort
399300;159440490000;262143;7449561;7711704;6925275;0.033752;quickSort
399400;159520360000;262143;7451361;7713504;6927075;0.033758;quickSort
399500;159600250000;262143;7453161;7715304;6928875;0.033773;quickSort
399600;159680160000;262143;7454961;7717104;6930675;0.033784;quickSort
399700;159760090000;262143;7456761;7718904;6932475;0.033929;quickSort
399800;159840040000;262143;7458561;7720704;6934275;0.033787;quickSort
399900;159920010000;262143;7460361;7722504;6936075;0.033800;quickSort
400000;160000000000;262143;7462161;7724304;6937875;0.033809;quickSort
400100;160080010000;262143;7463961;7726104;6939675;0.033831;quickSort
400200;160160040000;262143;7465761;7727904;6941475;0.034251;quickSort
400300;160240090000;262143;7467561;7729704;6943275;0.034555;quickSort
400400;160320160000;262143;7469361;7731504;6945075;0.036072;quickSort
400500;160400250000;262143;7471161;7733304;6946875;0.033796;quickSort
400600;160480360000;262143;7472961;7735104;6948675;0.033853;quickSort
400700;160560490000;262143;7474761;7736904;6950475;0.035782;quickSort
400800;160640640000;262143;7476561;7738704;6952275;0.034249;quickSort
400900;160720810000;262143;7478361;7740504;6954075;0.033898;quickSort
401000;160801000000;262143;7480161;7742304;6955875;0.033908;quickSort
401100;160881210000;262143;7481961;7744104;6957675;0.034115;quickSort
401200;160961440000;262143;7483761;7745904;6959475;0.033895;quickSort
401300;161041690000;262143;7485561;7747704;6961275;0.033934;quickSort
401400;161121960000;262143;7487361;7749504;6963075;0.034219;quickSort
401500;161202250000;262143;7489161;7751304;6964875;0.033927;quickSort
401600;161282560000;262143;7490961;7753104;6966675;0.034507;quickSort
401700;161362890000;262143;7492761;7754904;6968475;0.033919;quickSort
401800;161443240000;262143;7494561;7756704;6970275;0.035419;quickSort
401900;161523610000;262143;7496361;7758504;6972075;0.034514;quickSort
402000;161604000000;262143;7498161;7760304;6973875;0.035342;quickSort
402100;161684410000;262143;7499961;7762104;6975675;0.034489;quickSort
402200;161764840000;262143;7501761;7763904;6977475;0.034528;quickSort
402300;161845290000;262143;7503561;7765704;6979275;0.035140;quickSort
402400;161925760000;262143;7505361;7767504;6981075;0.034064;quickSort
402500;162006250000;262143;7507161;7769304;6982875;0.035235;quickSort
402600;162086760000;262143;7508961;7771104;6984675;0.034115;quickSort
402700;162167290000;262143;7510761;7772904;6986475;0.034035;quickSort
402800;162247840000;262143;7512561;7774704;6988275;0.036669;quickSort
402900;162328410000;262143;7514361;7776504;6990075;0.034079;quickSort
403000;162409000000;262143;7516161;7778304;6991875;0.034479;quickSort
403100;162489610000;262143;7517961;7780104;6993675;0.034069;quickSort
403200;162570240000;262143;7519761;7781904;6995475;0.034219;quickSort
403300;162650890000;262143;7521561;7783704;6997275;0.035719;quickSort
403400;162731560000;262143;7523361;7785504;6999075;0.034249;quickSort
403500;162812250000;262143;7525161;7787304;7000875;0.035009;quickSort
403600;162892960000;262143;7526961;7789104;7002675;0.034232;quickSort
403700;162973690000;262143;7528761;7790904;7004475;0.033390;quickSort
403800;163054440000;262143;7530561;7792704;7006275;0.033640;quickSort
403900;163135210000;262143;7532361;7794504;7008075;0.034158;quickSort
404000;163216000000;262143;7534161;7796304;7009875;0.034144;quickSort
404100;163296810000;262143;7535961;7798104;7011675;0.034155;quickSort
404200;163377640000;262143;7537761;7799904;7013475;0.034574;quickSort
404300;163458490000;262143;7539561;7801704;7015275;0.034184;quickSort
404400;163539360000;262143;7541361;7803504;7017075;0.034792;quickSort
404500;163620250000;262143;7543161;7805304;7018875;0.034658;quickSort
404600;163701160000;262143;7544961;7807104;7020675;0.034495;quickSort
404700;163782090000;262143;7546761;7808904;7022475;0.034469;quickSort
404800;163863040000;262143;7548561;7810704;7024275;0.034511;quickSort
404900;163944010000;262143;7550361;7812504;7026075;0.034396;quickSort
405000;164025000000;262143;7552161;7814304;7027875;0.034235;quickSort
405100;164106010000;262143;7553961;7816104;7029675;0.034226;quickSort
405200;164187040000;262143;7555761;7817904;7031475;0.034298;quickSort
405300;164268090000;262143;7557561;7819704;7033275;0.035300;quickSort
405400;164349160000;262143;7559361;7821504;7035075;0.034573;quickSort
405500;164430250000;262143;7561161;7823304;7036875;0.034348;quickSort
405600;164511360000;262143;7562961;7825104;7038675;0.034280;quickSort
405700;164592490000;262143;7564761;7826904;7040475;0.034478;quickSort
405800;164673640000;262143;7566561;7828704;7042275;0.036771;quickSort
405900;164754810000;262143;7568361;7830504;7044075;0.034609;quickSort
406000;164836000000;262143;7570161;7832304;7045875;0.034357;quickSort
406100;164917210000;262143;7571961;7834104;7047675;0.034927;quickSort
406200;164998440000;262143;7573761;7835904;7049475;0.034848;quickSort
406300;165079690000;262143;7575561;7837704;7051275;0.034388;quickSort
406400;165160960000;262143;7577361;7839504;7053075;0.034437;quickSort
406500;165242250000;262143;7579161;7841304;7054875;0.034496;quickSort
406600;165323560000;262143;7580961;7843104;7056675;0.034526;quickSort
406700;165404890000;262143;7582761;7844904;7058475;0.034427;quickSort
406800;165486240000;262143;7584561;7846704;7060275;0.036289;quickSort
406900;165567610000;262143;7586361;7848504;7062075;0.034465;quickSort
407000;165649000000;262143;7588161;7850304;7063875;0.034464;quickSort
407100;165730410000;262143;7589961;7852104;7065675;0.034473;quickSort
407200;165811840000;262143;7591761;7853904;7067475;0.034623;quickSort
407300;165893290000;262143;7593561;7855704;7069275;0.034787;quickSort
407400;165974760000;262143;7595361;7857504;7071075;0.034444;quickSort
407500;166056250000;262143;7597161;7859304;7072875;0.034738;quickSort
407600;166137760000;262143;7598961;7861104;7074675;0.035335;quickSort
407700;166219290000;262143;7600761;7862904;7076475;0.034458;quickSort
407800;166300840000;262143;7602561;7864704;7078275;0.034652;quickSort
407900;166382410000;262143;7604361;7866504;7080075;0.034521;quickSort
408000;166464000000;262143;7606161;7868304;7081875;0.034490;quickSort
408100;166545610000;262143;7607961;7870104;7083675;0.034113;quickSort
408200;166627240000;262143;7609761;7871904;7085475;0.034511;quickSort
408300;166708890000;262143;7611561;7873704;7087275;0.034527;quickSort
408400;166790560000;262143;7613361;7875504;7089075;0.034655;quickSort
408500;166872250000;262143;7615161;7877304;7090875;0.034589;quickSort
408600;166953960000;262143;7616961;7879104;7092675;0.034550;quickSort
408700;167035690000;262143;7618761;7880904;7094475;0.033742;quickSort
408800;167117440000;262143;7620561;7882704;7096275;0.034069;quickSort
408900;167199210000;262143;7622361;7884504;7098075;0.035111;quickSort
409000;167281000000;262143;7624161;7886304;7099875;0.034598;quickSort
409100;167362810000;262143;7625961;7888104;7101675;0.034851;quickSort
409200;167444640000;262143;7627761;7889904;7103475;0.035093;quickSort
409300;167526490000;262143;7629561;7891704;7105275;0.034595;quickSort
409400;167608360000;262143;7631361;7893504;7107075;0.034624;quickSort
409500;167690250000;262143;7633161;7895304;7108875;0.035036;quickSort
409600;167772160000;262143;7634961;7897104;7110675;0.035131;quickSort
409700;167854090000;262143;7636761;7898904;7112475;0.034651;quickSort
409800;167936040000;262143;7638561;7900704;7114275;0.034682;quickSort
409900;168018010000;262143;7640361;7902504;7116075;0.034485;quickSort
410000;168100000000;262143;7642161;7904304;7117875;0.033822;quickSort
410100;168182010000;262143;7643961;7906104;7119675;0.034272;quickSort
410200;168264040000;262143;7645761;7907904;7121475;0.034675;quickSort
410300;168346090000;262143;7647561;7909704;7123275;0.034744;quickSort
410400;168428160000;262143;7649361;7911504;7125075;0.035110;quickSort
410500;168510250000;262143;7651161;7913304;7126875;0.034791;quickSort
410600;168592360000;262143;7652961;7915104;7128675;0.036547;quickSort
410700;168674490000;262143;7654761;7916904;7130475;0.034785;quickSort
410800;168756640000;262143;7656561;7918704;7132275;0.034717;quickSort
410900;168838810000;262143;7658361;7920504;7134075;0.035442;quickSort
411000;168921000000;262143;7660161;7922304;7135875;0.034769;quickSort
411100;169003210000;262143;7661961;7924104;7137675;0.034733;quickSort
411200;169085440000;262143;7663761;7925904;7139475;0.034827;quickSort
411300;169167690000;262143;7665561;7927704;7141275;0.034708;quickSort
411400;169249960000;262143;7667361;7929504;7143075;0.034888;quickSort
411500;169332250000;262143;7669161;7931304;7144875;0.034757;quickSort
411600;169414560000;262143;7670961;7933104;7146675;0.034785;quickSort
411700;169496890000;262143;7672761;7934904;7148475;0.034774;quickSort
411800;169579240000;262143;7674561;7936704;7150275;0.034897;quickSort
411900;169661610000;262143;7676361;7938504;7152075;0.034969;quickSort
412000;169744000000;262143;7678161;7940304;7153875;0.034842;quickSort
412100;169826410000;262143;7679961;7942104;7155675;0.034820;quickSort
412200;169908840000;262143;7681761;7943904;7157475;0.034796;quickSort
412300;169991290000;262143;7683561;7945704;7159275;0.034828;quickSort
412400;170073760000;262143;7685361;7947504;7161075;0.034863;quickSort
412500;170156250000;262143;7687161;7949304;7162875;0.034894;quickSort
412600;170238760000;262143;7688961;7951104;7164675;0.034917;quickSort
412700;170321290000;262143;7690761;7952904;7166475;0.034878;quickSort
412800;170403840000;262143;7692561;7954704;7168275;0.034829;quickSort
412900;170486410000;262143;7694361;7956504;7170075;0.036627;quickSort
413000;170569000000;262143;7696161;7958304;7171875;0.037727;quickSort
413100;170651610000;262143;7697961;7960104;7173675;0.036157;quickSort
413200;170734240000;262143;7699761;7961904;7175475;0.036057;quickSort
413300;170816890000;262143;7701561;7963704;7177275;0.036173;quickSort
413400;170899560000;262143;7703361;7965504;7179075;0.035242;quickSort
413500;170982250000;262143;7705161;7967304;7180875;0.054214;quickSort
413600;171064960000;262143;7706961;7969104;7182675;0.036142;quickSort
413700;171147690000;262143;7708761;7970904;7184475;0.035096;quickSort
413800;171230440000;262143;7710561;7972704;7186275;0.034917;quickSort
413900;171313210000;262143;7712361;7974504;7188075;0.034989;quickSort
414000;171396000000;262143;7714161;7976304;7189875;0.034970;quickSort
414100;171478810000;262143;7715961;7978104;7191675;0.035037;quickSort
414200;171561640000;262143;7717761;7979904;7193475;0.035004;quickSort
414300;171644490000;262143;7719561;7981704;7195275;0.035248;quickSort
414400;171727360000;262143;7721361;7983504;7197075;0.035597;quickSort
414500;171810250000;262143;7723161;7985304;7198875;0.035253;quickSort
414600;171893160000;262143;7724961;7987104;7200675;0.035348;quickSort
414700;171976090000;262143;7726761;7988904;7202475;0.035741;quickSort
414800;172059040000;262143;7728561;7990704;7204275;0.035589;quickSort
414900;172142010000;262143;7730361;7992504;7206075;0.035212;quickSort
415000;172225000000;262143;7732161;7994304;7207875;0.035138;quickSort
415100;172308010000;262143;7733961;7996104;7209675;0.035197;quickSort
415200;172391040000;262143;7735761;7997904;7211475;0.036037;quickSort
415300;172474090000;262143;7737561;7999704;7213275;0.035159;quickSort
415400;172557160000;262143;7739361;8001504;7215075;0.035395;quickSort
415500;172640250000;262143;7741161;8003304;7216875;0.035489;quickSort
415600;172723360000;262143;7742961;8005104;7218675;0.036446;quickSort
415700;172806490000;262143;7744761;8006904;7220475;0.036620;quickSort
415800;172889640000;262143;7746561;8008704;7222275;0.035930;quickSort
415900;172972810000;262143;7748361;8010504;7224075;0.035122;quickSort
416000;173056000000;262143;7750161;8012304;7225875;0.035167;quickSort
416100;173139210000;262143;7751961;8014104;7227675;0.035218;quickSort
416200;173222440000;262143;7753761;8015904;7229475;0.034919;quickSort
416300;173305690000;262143;7755561;8017704;7231275;0.035428;quickSort
416400;173388960000;262143;7757361;8019504;7233075;0.036616;quickSort
416500;173472250000;262143;7759161;8021304;7234875;0.035155;quickSort
416600;173555560000;262143;7760961;8023104;7236675;0.035204;quickSort
416700;173638890000;262143;7762761;8024904;7238475;0.035127;quickSort
416800;173722240000;262143;7764561;8026704;7240275;0.035229;quickSort
416900;173805610000;262143;7766361;8028504;7242075;0.035860;quickSort
417000;173889000000;262143;7768161;8030304;7243875;0.035240;quickSort
417100;173972410000;262143;7769961;8032104;7245675;0.036012;quickSort
417200;174055840000;262143;7771761;8033904;7247475;0.038327;quickSort
417300;174139290000;262143;7773561;8035704;7249275;0.035161;quickSort
417400;174222760000;262143;7775361;8037504;7251075;0.035476;quickSort
417500;174306250000;262143;7777161;8039304;7252875;0.035283;quickSort
417600;174389760000;262143;7778961;8041104;7254675;0.035823;quickSort
417700;174473290000;262143;7780761;8042904;7256475;0.035328;quickSort
417800;174556840000;262143;7782561;8044704;7258275;0.035297;quickSort
417900;174640410000;262143;7784361;8046504;7260075;0.035398;quickSort
418000;174724000000;262143;7786161;8048304;7261875;0.035358;quickSort
418100;174807610000;262143;7787961;8050104;7263675;0.034659;quickSort
418200;174891240000;262143;7789761;8051904;7265475;0.035982;quickSort
418300;174974890000;262143;7791561;8053704;7267275;0.035377;quickSort
418400;175058560000;262143;7793361;8055504;7269075;0.036185;quickSort
418500;175142250000;262143;7795161;8057304;7270875;0.036957;quickSort
418600;175225960000;262143;7796961;8059104;7272675;0.035492;quickSort
418700;175309690000;262143;7798761;8060904;7274475;0.035451;quickSort
418800;175393440000;262143;7800561;8062704;7276275;0.035451;quickSort
418900;175477210000;262143;7802361;8064504;7278075;0.035318;quickSort
419000;175561000000;262143;7804161;8066304;7279875;0.035395;quickSort
419100;175644810000;262143;7805961;8068104;7281675;0.035305;quickSort
419200;175728640000;262143;7807761;8069904;7283475;0.035396;quickSort
419300;175812490000;262143;7809561;8071704;7285275;0.036260;quickSort
419400;175896360000;262143;7811361;8073504;7287075;0.035372;quickSort
419500;175980250000;262143;7813161;8075304;7288875;0.037762;quickSort
419600;176064160000;262143;7814961;8077104;7290675;0.038082;quickSort
419700;176148090000;262143;7816761;8078904;7292475;0.035859;quickSort
419800;176232040000;262143;7818561;8080704;7294275;0.035748;quickSort
419900;176316010000;262143;7820361;8082504;7296075;0.035998;quickSort
420000;176400000000;262143;7822161;8084304;7297875;0.036346;quickSort
420100;176484010000;262143;7823961;8086104;7299675;0.054741;quickSort
420200;176568040000;262143;7825761;8087904;7301475;0.035750;quickSort
420300;176652090000;262143;7827561;8089704;7303275;0.035581;quickSort
420400;176736160000;262143;7829361;8091504;7305075;0.037206;quickSort
420500;176820250000;262143;7831161;8093304;7306875;0.035559;quickSort
420600;176904360000;262143;7832961;8095104;7308675;0.035453;quickSort
420700;176988490000;262143;7834761;8096904;7310475;0.035508;quickSort
420800;177072640000;262143;7836561;8098704;7312275;0.035588;quickSort
420900;177156810000;262143;7838361;8100504;7314075;0.035478;quickSort
421000;177241000000;262143;7840161;8102304;7315875;0.035506;quickSort
421100;177325210000;262143;7841961;8104104;7317675;0.035616;quickSort
421200;177409440000;262143;7843761;8105904;7319475;0.035480;quickSort
421300;177493690000;262143;7845561;8107704;7321275;0.035472;quickSort
421400;177577960000;262143;7847361;8109504;7323075;0.035470;quickSort
421500;177662250000;262143;7849161;8111304;7324875;0.035551;quickSort
421600;177746560000;262143;7850961;8113104;7326675;0.035627;quickSort
421700;177830890000;262143;7852761;8114904;7328475;0.035490;quickSort
421800;177915240000;262143;7854561;8116704;7330275;0.034853;quickSort
421900;177999610000;262143;7856361;8118504;7332075;0.034635;quickSort
422000;178084000000;262143;7858161;8120304;7333875;0.035520;quickSort
422100;178168410000;262143;7859961;8122104;7335675;0.035881;quickSort
422200;178252840000;262143;7861761;8123904;7337475;0.035551;quickSort
422300;178337290000;262143;7863561;8125704;7339275;0.036079;quickSort
422400;178421760000;262143;7865361;8127504;7341075;0.035579;quickSort
422500;178506250000;262143;7867161;8129304;7342875;0.035640;quickSort
422600;178590760000;262143;7868961;8131104;7344675;0.035597;quickSort
422700;178675290000;262143;7870761;8132904;7346475;0.035577;quickSort
422800;178759840000;262143;7872561;8134704;7348275;0.034741;quickSort
422900;178844410000;262143;7874361;8136504;7350075;0.035668;quickSort
423000;178929000000;262143;7876161;8138304;7351875;0.035623;quickSort
423100;179013610000;262143;7877961;8140104;7353675;0.035547;quickSort
423200;179098240000;262143;7879761;8141904;7355475;0.035546;quickSort
423300;179182890000;262143;7881561;8143704;7357275;0.035785;quickSort
423400;179267560000;262143;7883361;8145504;7359075;0.037457;quickSort
423500;179352250000;262143;7885161;8147304;7360875;0.036013;quickSort
423600;179436960000;262143;7886961;8149104;7362675;0.036028;quickSort
423700;179521690000;262143;7888761;8150904;7364475;0.036493;quickSort
423800;179606440000;262143;7890561;8152704;7366275;0.035646;quickSort
423900;179691210000;262143;7892361;8154504;7368075;0.035964;quickSort
424000;179776000000;262143;7894161;8156304;7369875;0.037508;quickSort
424100;179860810000;262143;7895961;8158104;7371675;0.035708;quickSort
424200;179945640000;262143;7897761;8159904;7373475;0.035681;quickSort
424300;180030490000;262143;7899561;8161704;7375275;0.035691;quickSort
424400;180115360000;262143;7901361;8163504;7377075;0.035673;quickSort
424500;180200250000;262143;7903161;8165304;7378875;0.035881;quickSort
424600;180285160000;262143;7904961;8167104;7380675;0.036347;quickSort
424700;180370090000;262143;7906761;8168904;7382475;0.035679;quickSort
424800;180455040000;262143;7908561;8170704;7384275;0.035680;quickSort
424900;180540010000;262143;7910361;8172504;7386075;0.037089;quickSort
425000;180625000000;262143;7912161;8174304;7387875;0.035727;quickSort
425100;180710010000;262143;7913961;8176104;7389675;0.036233;quickSort
425200;180795040000;262143;7915761;8177904;7391475;0.035873;quickSort
425300;180880090000;262143;7917561;8179704;7393275;0.037572;quickSort
425400;180965160000;262143;7919361;8181504;7395075;0.035828;quickSort
425500;181050250000;262143;7921161;8183304;7396875;0.036312;quickSort
425600;181135360000;262143;7922961;8185104;7398675;0.035714;quickSort
425700;181220490000;262143;7924761;8186904;7400475;0.035706;quickSort
425800;181305640000;262143;7926561;8188704;7402275;0.035762;quickSort
425900;181390810000;262143;7928361;8190504;7404075;0.035789;quickSort
426000;181476000000;262143;7930161;8192304;7405875;0.036057;quickSort
426100;181561210000;262143;7931961;8194104;7407675;0.035223;quickSort
426200;181646440000;262143;7933761;8195904;7409475;0.035808;quickSort
426300;181731690000;262143;7935561;8197704;7411275;0.035803;quickSort
426400;181816960000;262143;7937361;8199504;7413075;0.035792;quickSort
426500;181902250000;262143;7939161;8201304;7414875;0.035803;quickSort
426600;181987560000;262143;7940961;8203104;7416675;0.036072;quickSort
426700;182072890000;262143;7942761;8204904;7418475;0.035765;quickSort
426800;182158240000;262143;7944561;8206704;7420275;0.035821;quickSort
426900;182243610000;262143;7946361;8208504;7422075;0.035823;quickSort
427000;182329000000;262143;7948161;8210304;7423875;0.035801;quickSort
427100;182414410000;262143;7949961;8212104;7425675;0.035883;quickSort
427200;182499840000;262143;7951761;8213904;7427475;0.035935;quickSort
427300;182585290000;262143;7953561;8215704;7429275;0.035835;quickSort
427400;182670760000;262143;7955361;8217504;7431075;0.035808;quickSort
427500;182756250000;262143;7957161;8219304;7432875;0.035838;quickSort
427600;182841760000;262143;7958961;8221104;7434675;0.035861;quickSort
427700;182927290000;262143;7960761;8222904;7436475;0.035982;quickSort
427800;183012840000;262143;7962561;8224704;7438275;0.035900;quickSort
427900;183098410000;262143;7964361;8226504;7440075;0.035868;quickSort
428000;183184000000;262143;7966161;8228304;7441875;0.036032;quickSort
428100;183269610000;262143;7967961;8230104;7443675;0.036078;quickSort
428200;183355240000;262143;7969761;8231904;7445475;0.036084;quickSort
428300;183440890000;262143;7971561;8233704;7447275;0.036340;quickSort
428400;183526560000;262143;7973361;8235504;7449075;0.035506;quickSort
428500;183612250000;262143;7975161;8237304;7450875;0.036721;quickSort
428600;183697960000;262143;7976961;8239104;7452675;0.036089;quickSort
428700;183783690000;262143;7978761;8240904;7454475;0.036557;quickSort
428800;183869440000;262143;7980561;8242704;7456275;0.035976;quickSort
428900;183955210000;262143;7982361;8244504;7458075;0.056665;quickSort
429000;184041000000;262143;7984161;8246304;7459875;0.035938;quickSort
429100;184126810000;262143;7985961;8248104;7461675;0.035940;quickSort
429200;184212640000;262143;7987761;8249904;7463475;0.037852;quickSort
429300;184298490000;262143;7989561;8251704;7465275;0.036316;quickSort
429400;184384360000;262143;7991361;8253504;7467075;0.036187;quickSort
429500;184470250000;262143;7993161;8255304;7468875;0.035994;quickSort
429600;184556160000;262143;7994961;8257104;7470675;0.035988;quickSort
429700;184642090000;262143;7996761;8258904;7472475;0.036192;quickSort
429800;184728040000;262143;7998561;8260704;7474275;0.036008;quickSort
429900;184814010000;262143;8000361;8262504;7476075;0.036066;quickSort
430000;184900000000;262143;8002161;8264304;7477875;0.036061;quickSort
430100;184986010000;262143;8003961;8266104;7479675;0.036014;quickSort
430200;185072040000;262143;8005761;8267904;7481475;0.037331;quickSort
430300;185158090000;262143;8007561;8269704;7483275;0.037537;quickSort
430400;185244160000;262143;8009361;8271504;7485075;0.036601;quickSort
430500;185330250000;262143;8011161;8273304;7486875;0.036050;quickSort
430600;185416360000;262143;8012961;8275104;7488675;0.036133;quickSort
430700;185502490000;262143;8014761;8276904;7490475;0.036127;quickSort
430800;185588640000;262143;8016561;8278704;7492275;0.038868;quickSort
430900;185674810000;262143;8018361;8280504;7494075;0.036128;quickSort
431000;185761000000;262143;8020161;8282304;7495875;0.036096;quickSort
431100;185847210000;262143;8021961;8284104;7497675;0.036094;quickSort
431200;185933440000;262143;8023761;8285904;7499475;0.036167;quickSort
431300;186019690000;262143;8025561;8287704;7501275;0.036133;quickSort
431400;186105960000;262143;8027361;8289504;7503075;0.036066;quickSort
431500;186192250000;262143;8029161;8291304;7504875;0.036126;quickSort
431600;186278560000;262143;8030961;8293104;7506675;0.036104;quickSort
431700;186364890000;262143;8032761;8294904;7508475;0.036157;quickSort
431800;186451240000;262143;8034561;8296704;7510275;0.036245;quickSort
431900;186537610000;262143;8036361;8298504;7512075;0.036162;quickSort
432000;186624000000;262143;8038161;8300304;7513875;0.036173;quickSort
432100;186710410000;262143;8039961;8302104;7515675;0.036167;quickSort
432200;186796840000;262143;8041761;8303904;7517475;0.037442;quickSort
432300;186883290000;262143;8043561;8305704;7519275;0.036249;quickSort
432400;186969760000;262143;8045361;8307504;7521075;0.036279;quickSort
432500;187056250000;262143;8047161;8309304;7522875;0.036267;quickSort
432600;187142760000;262143;8048961;8311104;7524675;0.036181;quickSort
432700;187229290000;262143;8050761;8312904;7526475;0.036129;quickSort
432800;187315840000;262143;8052561;8314704;7528275;0.036220;quickSort
432900;187402410000;262143;8054361;8316504;7530075;0.036918;quickSort
433000;187489000000;262143;8056161;8318304;7531875;0.036144;quickSort
433100;187575610000;262143;8057961;8320104;7533675;0.036251;quickSort
433200;187662240000;262143;8059761;8321904;7535475;0.036251;quickSort
433300;187748890000;262143;8061561;8323704;7537275;0.036316;quickSort
433400;187835560000;262143;8063361;8325504;7539075;0.036306;quickSort
433500;187922250000;262143;8065161;8327304;7540875;0.036216;quickSort
433600;188008960000;262143;8066961;8329104;7542675;0.036249;quickSort
433700;188095690000;262143;8068761;8330904;7544475;0.036271;quickSort
433800;188182440000;262143;8070561;8332704;7546275;0.036194;quickSort
433900;188269210000;262143;8072361;8334504;7548075;0.036271;quickSort
434000;188356000000;262143;8074161;8336304;7549875;0.036321;quickSort
434100;188442810000;262143;8075961;8338104;7551675;0.036271;quickSort
434200;188529640000;262143;8077761;8339904;7553475;0.036282;quickSort
434300;188616490000;262143;8079561;8341704;7555275;0.036293;quickSort
434400;188703360000;262143;8081361;8343504;7557075;0.036293;quickSort
434500;188790250000;262143;8083161;8345304;7558875;0.036628;quickSort
434600;188877160000;262143;8084961;8347104;7560675;0.036900;quickSort
434700;188964090000;262143;8086761;8348904;7562475;0.037094;quickSort
434800;189051040000;262143;8088561;8350704;7564275;0.036533;quickSort
434900;189138010000;262143;8090361;8352504;7566075;0.036407;quickSort
435000;189225000000;262143;8092161;8354304;7567875;0.036829;quickSort
435100;189312010000;262143;8093961;8356104;7569675;0.036998;quickSort
435200;189399040000;262143;8095761;8357904;7571475;0.036672;quickSort
435300;189486090000;262143;8097561;8359704;7573275;0.036404;quickSort
435400;189573160000;262143;8099361;8361504;7575075;0.036376;quickSort
435500;189660250000;262143;8101161;8363304;7576875;0.037523;quickSort
435600;189747360000;262143;8102961;8365104;7578675;0.037191;quickSort
435700;189834490000;262143;8104761;8366904;7580475;0.036966;quickSort
435800;189921640000;262143;8106561;8368704;7582275;0.036391;quickSort
435900;190008810000;262143;8108361;8370504;7584075;0.036402;quickSort
436000;190096000000;262143;8110161;8372304;7585875;0.036429;quickSort
436100;190183210000;262143;8111961;8374104;7587675;0.036426;quickSort
436200;190270440000;262143;8113761;8375904;7589475;0.036216;quickSort
436300;190357690000;262143;8115561;8377704;7591275;0.035600;quickSort
436400;190444960000;262143;8117361;8379504;7593075;0.036424;quickSort
436500;190532250000;262143;8119161;8381304;7594875;0.036538;quickSort
436600;190619560000;262143;8120961;8383104;7596675;0.036428;quickSort
436700;190706890000;262143;8122761;8384904;7598475;0.036645;quickSort
436800;190794240000;262143;8124561;8386704;7600275;0.036444;quickSort
436900;190881610000;262143;8126361;8388504;7602075;0.036459;quickSort
437000;190969000000;262143;8128161;8390304;7603875;0.036455;quickSort
437100;191056410000;262143;8129961;8392104;7605675;0.036455;quickSort
437200;191143840000;262143;8131761;8393904;7607475;0.036544;quickSort
437300;191231290000;262143;8133561;8395704;7609275;0.036528;quickSort
437400;191318760000;262143;8135361;8397504;7611075;0.036765;quickSort
437500;191406250000;262143;8137161;8399304;7612875;0.036165;quickSort
437600;191493760000;262143;8138961;8401104;7614675;0.035635;quickSort
437700;191581290000;262143;8140761;8402904;7616475;0.036665;quickSort
437800;191668840000;262143;8142561;8404704;7618275;0.036709;quickSort
437900;191756410000;262143;8144361;8406504;7620075;0.036599;quickSort
438000;191844000000;262143;8146161;8408304;7621875;0.036595;quickSort
438100;191931610000;262143;8147961;8410104;7623675;0.037423;quickSort
438200;192019240000;262143;8149761;8411904;7625475;0.037316;quickSort
438300;192106890000;262143;8151561;8413704;7627275;0.036718;quickSort
438400;192194560000;262143;8153361;8415504;7629075;0.036691;quickSort
438500;192282250000;262143;8155161;8417304;7630875;0.036619;quickSort
438600;192369960000;262143;8156961;8419104;7632675;0.036691;quickSort
438700;192457690000;262143;8158761;8420904;7634475;0.036684;quickSort
438800;192545440000;262143;8160561;8422704;7636275;0.037201;quickSort
438900;192633210000;262143;8162361;8424504;7638075;0.036934;quickSort
439000;192721000000;262143;8164161;8426304;7639875;0.036684;quickSort
439100;192808810000;262143;8165961;8428104;7641675;0.036629;quickSort
439200;192896640000;262143;8167761;8429904;7643475;0.036682;quickSort
439300;192984490000;262143;8169561;8431704;7645275;0.037630;quickSort
439400;193072360000;262143;8171361;8433504;7647075;0.036817;quickSort
439500;193160250000;262143;8173161;8435304;7648875;0.036639;quickSort
439600;193248160000;262143;8174961;8437104;7650675;0.036702;quickSort
439700;193336090000;262143;8176761;8438904;7652475;0.036701;quickSort
439800;193424040000;262143;8178561;8440704;7654275;0.036700;quickSort
439900;193512010000;262143;8180361;8442504;7656075;0.035967;quickSort
440000;193600000000;262143;8182161;8444304;7657875;0.036707;quickSort
440100;193688010000;262143;8183961;8446104;7659675;0.036786;quickSort
440200;193776040000;262143;8185761;8447904;7661475;0.037016;quickSort
440300;193864090000;262143;8187561;8449704;7663275;0.037513;quickSort
440400;193952160000;262143;8189361;8451504;7665075;0.036900;quickSort
440500;194040250000;262143;8191161;8453304;7666875;0.037522;quickSort
440600;194128360000;262143;8192961;8455104;7668675;0.037382;quickSort
440700;194216490000;262143;8194761;8456904;7670475;0.036972;quickSort
440800;194304640000;262143;8196561;8458704;7672275;0.037275;quickSort
440900;194392810000;262143;8198361;8460504;7674075;0.037010;quickSort
441000;194481000000;262143;8200161;8462304;7675875;0.036889;quickSort
441100;194569210000;262143;8201961;8464104;7677675;0.036750;quickSort
441200;194657440000;262143;8203761;8465904;7679475;0.036763;quickSort
441300;194745690000;262143;8205561;8467704;7681275;0.036925;quickSort
441400;194833960000;262143;8207361;8469504;7683075;0.037073;quickSort
441500;194922250000;262143;8209161;8471304;7684875;0.036747;quickSort
441600;195010560000;262143;8210961;8473104;7686675;0.036773;quickSort
441700;195098890000;262143;8212761;8474904;7688475;0.036759;quickSort
441800;195187240000;262143;8214561;8476704;7690275;0.036975;quickSort
441900;195275610000;262143;8216361;8478504;7692075;0.038436;quickSort
442000;195364000000;262143;8218161;8480304;7693875;0.037770;quickSort
442100;195452410000;262143;8219961;8482104;7695675;0.038072;quickSort
442200;195540840000;262143;8221761;8483904;7697475;0.055484;quickSort
442300;195629290000;262143;8223561;8485704;7699275;0.038424;quickSort
442400;195717760000;262143;8225361;8487504;7701075;0.039761;quickSort
442500;195806250000;262143;8227161;8489304;7702875;0.036926;quickSort
442600;195894760000;262143;8228961;8491104;7704675;0.037364;quickSort
442700;195983290000;262143;8230761;8492904;7706475;0.036952;quickSort
442800;196071840000;262143;8232561;8494704;7708275;0.037690;quickSort
442900;196160410000;262143;8234361;8496504;7710075;0.037793;quickSort
443000;196249000000;262143;8236161;8498304;7711875;0.036864;quickSort
443100;196337610000;262143;8237961;8500104;7713675;0.039129;quickSort
443200;196426240000;262143;8239761;8501904;7715475;0.036970;quickSort
443300;196514890000;262143;8241561;8503704;7717275;0.037053;quickSort
443400;196603560000;262143;8243361;8505504;7719075;0.037089;quickSort
443500;196692250000;262143;8245161;8507304;7720875;0.037042;quickSort
443600;196780960000;262143;8246961;8509104;7722675;0.036986;quickSort
443700;196869690000;262143;8248761;8510904;7724475;0.038159;quickSort
443800;196958440000;262143;8250561;8512704;7726275;0.038005;quickSort
443900;197047210000;262143;8252361;8514504;7728075;0.037354;quickSort
444000;197136000000;262143;8254161;8516304;7729875;0.036942;quickSort
444100;197224810000;262143;8255961;8518104;7731675;0.036904;quickSort
444200;197313640000;262143;8257761;8519904;7733475;0.036854;quickSort
444300;197402490000;262143;8259561;8521704;7735275;0.037090;quickSort
444400;197491360000;262143;8261361;8523504;7737075;0.036993;quickSort
444500;197580250000;262143;8263161;8525304;7738875;0.037716;quickSort
444600;197669160000;262143;8264961;8527104;7740675;0.038170;quickSort
444700;197758090000;262143;8266761;8528904;7742475;0.036916;quickSort
444800;197847040000;262143;8268561;8530704;7744275;0.040917;quickSort
444900;197936010000;262143;8270361;8532504;7746075;0.038224;quickSort
445000;198025000000;262143;8272161;8534304;7747875;0.037057;quickSort
445100;198114010000;262143;8273961;8536104;7749675;0.037841;quickSort
445200;198203040000;262143;8275761;8537904;7751475;0.037899;quickSort
445300;198292090000;262143;8277561;8539704;7753275;0.037690;quickSort
445400;198381160000;262143;8279361;8541504;7755075;0.037561;quickSort
445500;198470250000;262143;8281161;8543304;7756875;0.037448;quickSort
445600;198559360000;262143;8282961;8545104;7758675;0.038012;quickSort
445700;198648490000;262143;8284761;8546904;7760475;0.037183;quickSort
445800;198737640000;262143;8286561;8548704;7762275;0.038139;quickSort
445900;198826810000;262143;8288361;8550504;7764075;0.037861;quickSort
446000;198916000000;262143;8290161;8552304;7765875;0.037233;quickSort
446100;199005210000;262143;8291961;8554104;7767675;0.037290;quickSort
446200;199094440000;262143;8293761;8555904;7769475;0.037662;quickSort
446300;199183690000;262143;8295561;8557704;7771275;0.038669;quickSort
446400;199272960000;262143;8297361;8559504;7773075;0.039672;quickSort
446500;199362250000;262143;8299161;8561304;7774875;0.037493;quickSort
446600;199451560000;262143;8300961;8563104;7776675;0.037162;quickSort
446700;199540890000;262143;8302761;8564904;7778475;0.037086;quickSort
446800;199630240000;262143;8304561;8566704;7780275;0.037080;quickSort
446900;199719610000;262143;8306361;8568504;7782075;0.037245;quickSort
447000;199809000000;262143;8308161;8570304;7783875;0.036149;quickSort
447100;199898410000;262143;8309961;8572104;7785675;0.036798;quickSort
447200;199987840000;262143;8311761;8573904;7787475;0.037598;quickSort
447300;200077290000;262143;8313561;8575704;7789275;0.037104;quickSort
447400;200166760000;262143;8315361;8577504;7791075;0.037886;quickSort
447500;200256250000;262143;8317161;8579304;7792875;0.037195;quickSort
447600;200345760000;262143;8318961;8581104;7794675;0.037685;quickSort
447700;200435290000;262143;8320761;8582904;7796475;0.038000;quickSort
447800;200524840000;262143;8322561;8584704;7798275;0.037095;quickSort
447900;200614410000;262143;8324361;8586504;7800075;0.037082;quickSort
448000;200704000000;262143;8326161;8588304;7801875;0.037222;quickSort
448100;200793610000;262143;8327961;8590104;7803675;0.037054;quickSort
448200;200883240000;262143;8329761;8591904;7805475;0.037106;quickSort
448300;200972890000;262143;8331561;8593704;7807275;0.037159;quickSort
448400;201062560000;262143;8333361;8595504;7809075;0.037131;quickSort
448500;201152250000;262143;8335161;8597304;7810875;0.038878;quickSort
448600;201241960000;262143;8336961;8599104;7812675;0.037110;quickSort
448700;201331690000;262143;8338761;8600904;7814475;0.037182;quickSort
448800;201421440000;262143;8340561;8602704;7816275;0.037101;quickSort
448900;201511210000;262143;8342361;8604504;7818075;0.037160;quickSort
449000;201601000000;262143;8344161;8606304;7819875;0.037299;quickSort
449100;201690810000;262143;8345961;8608104;7821675;0.037242;quickSort
449200;201780640000;262143;8347761;8609904;7823475;0.037217;quickSort
449300;201870490000;262143;8349561;8611704;7825275;0.037195;quickSort
449400;201960360000;262143;8351361;8613504;7827075;0.037158;quickSort
449500;202050250000;262143;8353161;8615304;7828875;0.037258;quickSort
449600;202140160000;262143;8354961;8617104;7830675;0.037238;quickSort
449700;202230090000;262143;8356761;8618904;7832475;0.037277;quickSort
449800;202320040000;262143;8358561;8620704;7834275;0.037140;quickSort
449900;202410010000;262143;8360361;8622504;7836075;0.037193;quickSort
450000;202500000000;262143;8362161;8624304;7837875;0.037200;quickSort
450100;202590010000;262143;8363961;8626104;7839675;0.037324;quickSort
450200;202680040000;262143;8365761;8627904;7841475;0.037224;quickSort
450300;202770090000;262143;8367561;8629704;7843275;0.037257;quickSort
450400;202860160000;262143;8369361;8631504;7845075;0.037227;quickSort
450500;202950250000;262143;8371161;8633304;7846875;0.037332;quickSort
450600;203040360000;262143;8372961;8635104;7848675;0.037358;quickSort
450700;203130490000;262143;8374761;8636904;7850475;0.037221;quickSort
450800;203220640000;262143;8376561;8638704;7852275;0.037476;quickSort
450900;203310810000;262143;8378361;8640504;7854075;0.037277;quickSort
451000;203401000000;262143;8380161;8642304;7855875;0.037547;quickSort
451100;203491210000;262143;8381961;8644104;7857675;0.037269;quickSort
451200;203581440000;262143;8383761;8645904;7859475;0.037307;quickSort
451300;203671690000;262143;8385561;8647704;7861275;0.037611;quickSort
451400;203761960000;262143;8387361;8649504;7863075;0.037323;quickSort
451500;203852250000;262143;8389161;8651304;7864875;0.037276;quickSort
451600;203942560000;262143;8390961;8653104;7866675;0.037152;quickSort
451700;204032890000;262143;8392761;8654904;7868475;0.036397;quickSort
451800;204123240000;262143;8394561;8656704;7870275;0.037009;quickSort
451900;204213610000;262143;8396361;8658504;7872075;0.037615;quickSort
452000;204304000000;262143;8398161;8660304;7873875;0.037277;quickSort
452100;204394410000;262143;8399961;8662104;7875675;0.037294;quickSort
452200;204484840000;262143;8401761;8663904;7877475;0.037327;quickSort
452300;204575290000;262143;8403561;8665704;7879275;0.037297;quickSort
452400;204665760000;262143;8405361;8667504;7881075;0.055053;quickSort
452500;204756250000;262143;8407161;8669304;7882875;0.037240;quickSort
452600;204846760000;262143;8408961;8671104;7884675;0.036487;quickSort
452700;204937290000;262143;8410761;8672904;7886475;0.037553;quickSort
452800;205027840000;262143;8412561;8674704;7888275;0.037299;quickSort
452900;205118410000;262143;8414361;8676504;7890075;0.037369;quickSort
453000;205209000000;262143;8416161;8678304;7891875;0.037426;quickSort
453100;205299610000;262143;8417961;8680104;7893675;0.037470;quickSort
453200;205390240000;262143;8419761;8681904;7895475;0.037643;quickSort
453300;205480890000;262143;8421561;8683704;7897275;0.037398;quickSort
453400;205571560000;262143;8423361;8685504;7899075;0.037396;quickSort
453500;205662250000;262143;8425161;8687304;7900875;0.037365;quickSort
453600;205752960000;262143;8426961;8689104;7902675;0.037339;quickSort
453700;205843690000;262143;8428761;8690904;7904475;0.037429;quickSort
453800;205934440000;262143;8430561;8692704;7906275;0.037410;quickSort
453900;206025210000;262143;8432361;8694504;7908075;0.037393;quickSort
454000;206116000000;262143;8434161;8696304;7909875;0.037371;quickSort
454100;206206810000;262143;8435961;8698104;7911675;0.037363;quickSort
454200;206297640000;262143;8437761;8699904;7913475;0.037648;quickSort
454300;206388490000;262143;8439561;8701704;7915275;0.037368;quickSort
454400;206479360000;262143;8441361;8703504;7917075;0.037410;quickSort
454500;206570250000;262143;8443161;8705304;7918875;0.038415;quickSort
454600;206661160000;262143;8444961;8707104;7920675;0.037373;quickSort
454700;206752090000;262143;8446761;8708904;7922475;0.037427;quickSort
454800;206843040000;262143;8448561;8710704;7924275;0.037441;quickSort
454900;206934010000;262143;8450361;8712504;7926075;0.037339;quickSort
455000;207025000000;262143;8452161;8714304;7927875;0.036712;quickSort
455100;207116010000;262143;8453961;8716104;7929675;0.038298;quickSort
455200;207207040000;262143;8455761;8717904;7931475;0.037776;quickSort
455300;207298090000;262143;8457561;8719704;7933275;0.037426;quickSort
455400;207389160000;262143;8459361;8721504;7935075;0.038095;quickSort
455500;207480250000;262143;8461161;8723304;7936875;0.037589;quickSort
455600;207571360000;262143;8462961;8725104;7938675;0.037477;quickSort
455700;207662490000;262143;8464761;8726904;7940475;0.037445;quickSort
455800;207753640000;262143;8466561;8728704;7942275;0.037537;quickSort
455900;207844810000;262143;8468361;8730504;7944075;0.038268;quickSort
456000;207936000000;262143;8470161;8732304;7945875;0.037985;quickSort
456100;208027210000;262143;8471961;8734104;7947675;0.037484;quickSort
456200;208118440000;262143;8473761;8735904;7949475;0.037474;quickSort
456300;208209690000;262143;8475561;8737704;7951275;0.038231;quickSort
456400;208300960000;262143;8477361;8739504;7953075;0.037510;quickSort
456500;208392250000;262143;8479161;8741304;7954875;0.038069;quickSort
456600;208483560000;262143;8480961;8743104;7956675;0.037541;quickSort
456700;208574890000;262143;8482761;8744904;7958475;0.037471;quickSort
456800;208666240000;262143;8484561;8746704;7960275;0.039215;quickSort
456900;208757610000;262143;8486361;8748504;7962075;0.037655;quickSort
457000;208849000000;262143;8488161;8750304;7963875;0.037598;quickSort
457100;208940410000;262143;8489961;8752104;7965675;0.039011;quickSort
457200;209031840000;262143;8491761;8753904;7967475;0.037495;quickSort
457300;209123290000;262143;8493561;8755704;7969275;0.038089;quickSort
457400;209214760000;262143;8495361;8757504;7971075;0.037821;quickSort
457500;209306250000;262143;8497161;8759304;7972875;0.037558;quickSort
457600;209397760000;262143;8498961;8761104;7974675;0.037550;quickSort
457700;209489290000;262143;8500761;8762904;7976475;0.037671;quickSort
457800;209580840000;262143;8502561;8764704;7978275;0.037920;quickSort
457900;209672410000;262143;8504361;8766504;7980075;0.037537;quickSort
458000;209764000000;262143;8506161;8768304;7981875;0.037591;quickSort
458100;209855610000;262143;8507961;8770104;7983675;0.037523;quickSort
458200;209947240000;262143;8509761;8771904;7985475;0.037558;quickSort
458300;210038890000;262143;8511561;8773704;7987275;0.037616;quickSort
458400;210130560000;262143;8513361;8775504;7989075;0.037674;quickSort
458500;210222250000;262143;8515161;8777304;7990875;0.037005;quickSort
458600;210313960000;262143;8516961;8779104;7992675;0.037615;quickSort
458700;210405690000;262143;8518761;8780904;7994475;0.037553;quickSort
458800;210497440000;262143;8520561;8782704;7996275;0.038255;quickSort
458900;210589210000;262143;8522361;8784504;7998075;0.038171;quickSort
459000;210681000000;262143;8524161;8786304;7999875;0.037741;quickSort
459100;210772810000;262143;8525961;8788104;8001675;0.037712;quickSort
459200;210864640000;262143;8527761;8789904;8003475;0.037655;quickSort
459300;210956490000;262143;8529561;8791704;8005275;0.037696;quickSort
459400;211048360000;262143;8531361;8793504;8007075;0.037827;quickSort
459500;211140250000;262143;8533161;8795304;8008875;0.037697;quickSort
459600;211232160000;262143;8534961;8797104;8010675;0.036760;quickSort
459700;211324090000;262143;8536761;8798904;8012475;0.037241;quickSort
459800;211416040000;262143;8538561;8800704;8014275;0.037719;quickSort
459900;211508010000;262143;8540361;8802504;8016075;0.039703;quickSort
460000;211600000000;262143;8542161;8804304;8017875;0.037174;quickSort
460100;211692010000;262143;8543961;8806104;8019675;0.038246;quickSort
460200;211784040000;262143;8545761;8807904;8021475;0.038761;quickSort
460300;211876090000;262143;8547561;8809704;8023275;0.037717;quickSort
460400;211968160000;262143;8549361;8811504;8025075;0.037758;quickSort
460500;212060250000;262143;8551161;8813304;8026875;0.037749;quickSort
460600;212152360000;262143;8552961;8815104;8028675;0.037678;quickSort
460700;212244490000;262143;8554761;8816904;8030475;0.037762;quickSort
460800;212336640000;262143;8556561;8818704;8032275;0.037714;quickSort
460900;212428810000;262143;8558361;8820504;8034075;0.037855;quickSort
461000;212521000000;262143;8560161;8822304;8035875;0.038106;quickSort
461100;212613210000;262143;8561961;8824104;8037675;0.038035;quickSort
461200;212705440000;262143;8563761;8825904;8039475;0.037760;quickSort
461300;212797690000;262143;8565561;8827704;8041275;0.037900;quickSort
461400;212889960000;262143;8567361;8829504;8043075;0.037994;quickSort
461500;212982250000;262143;8569161;8831304;8044875;0.038671;quickSort
461600;213074560000;262143;8570961;8833104;8046675;0.038224;quickSort
461700;213166890000;262143;8572761;8834904;8048475;0.038031;quickSort
461800;213259240000;262143;8574561;8836704;8050275;0.038169;quickSort
461900;213351610000;262143;8576361;8838504;8052075;0.037952;quickSort
462000;213444000000;262143;8578161;8840304;8053875;0.037906;quickSort
462100;213536410000;262143;8579961;8842104;8055675;0.037867;quickSort
462200;213628840000;262143;8581761;8843904;8057475;0.037853;quickSort
462300;213721290000;262143;8583561;8845704;8059275;0.037887;quickSort
462400;213813760000;262143;8585361;8847504;8061075;0.038028;quickSort
462500;213906250000;262143;8587161;8849304;8062875;0.038241;quickSort
462600;213998760000;262143;8588961;8851104;8064675;0.038442;quickSort
462700;214091290000;262143;8590761;8852904;8066475;0.038820;quickSort
462800;214183840000;262143;8592561;8854704;8068275;0.037890;quickSort
462900;214276410000;262143;8594361;8856504;8070075;0.038248;quickSort
463000;214369000000;262143;8596161;8858304;8071875;0.039133;quickSort
463100;214461610000;262143;8597961;8860104;8073675;0.038337;quickSort
463200;214554240000;262143;8599761;8861904;8075475;0.038182;quickSort
463300;214646890000;262143;8601561;8863704;8077275;0.039385;quickSort
463400;214739560000;262143;8603361;8865504;8079075;0.037996;quickSort
463500;214832250000;262143;8605161;8867304;8080875;0.038193;quickSort
463600;214924960000;262143;8606961;8869104;8082675;0.037956;quickSort
463700;215017690000;262143;8608761;8870904;8084475;0.038967;quickSort
463800;215110440000;262143;8610561;8872704;8086275;0.038724;quickSort
463900;215203210000;262143;8612361;8874504;8088075;0.037729;quickSort
464000;215296000000;262143;8614161;8876304;8089875;0.037080;quickSort
464100;215388810000;262143;8615961;8878104;8091675;0.038410;quickSort
464200;215481640000;262143;8617761;8879904;8093475;0.038951;quickSort
464300;215574490000;262143;8619561;8881704;8095275;0.038183;quickSort
464400;215667360000;262143;8621361;8883504;8097075;0.038242;quickSort
464500;215760250000;262143;8623161;8885304;8098875;0.038064;quickSort
464600;215853160000;262143;8624961;8887104;8100675;0.038375;quickSort
464700;215946090000;262143;8626761;8888904;8102475;0.039531;quickSort
464800;216039040000;262143;8628561;8890704;8104275;0.038172;quickSort
464900;216132010000;262143;8630361;8892504;8106075;0.039479;quickSort
465000;216225000000;262143;8632161;8894304;8107875;0.041137;quickSort
465100;216318010000;262143;8633961;8896104;8109675;0.039180;quickSort
465200;216411040000;262143;8635761;8897904;8111475;0.038396;quickSort
465300;216504090000;262143;8637561;8899704;8113275;0.038057;quickSort
465400;216597160000;262143;8639361;8901504;8115075;0.038551;quickSort
465500;216690250000;262143;8641161;8903304;8116875;0.038183;quickSort
465600;216783360000;262143;8642961;8905104;8118675;0.038073;quickSort
465700;216876490000;262143;8644761;8906904;8120475;0.038966;quickSort
465800;216969640000;262143;8646561;8908704;8122275;0.038094;quickSort
465900;217062810000;262143;8648361;8910504;8124075;0.038189;quickSort
466000;217156000000;262143;8650161;8912304;8125875;0.038124;quickSort
466100;217249210000;262143;8651961;8914104;8127675;0.038187;quickSort
466200;217342440000;262143;8653761;8915904;8129475;0.038367;quickSort
466300;217435690000;262143;8655561;8917704;8131275;0.038598;quickSort
466400;217528960000;262143;8657361;8919504;8133075;0.038354;quickSort
466500;217622250000;262143;8659161;8921304;8134875;0.038877;quickSort
466600;217715560000;262143;8660961;8923104;8136675;0.038150;quickSort
466700;217808890000;262143;8662761;8924904;8138475;0.040586;quickSort
466800;217902240000;262143;8664561;8926704;8140275;0.039788;quickSort
466900;217995610000;262143;8666361;8928504;8142075;0.039118;quickSort
467000;218089000000;262143;8668161;8930304;8143875;0.038249;quickSort
467100;218182410000;262143;8669961;8932104;8145675;0.038710;quickSort
467200;218275840000;262143;8671761;8933904;8147475;0.038237;quickSort
467300;218369290000;262143;8673561;8935704;8149275;0.038880;quickSort
467400;218462760000;262143;8675361;8937504;8151075;0.039373;quickSort
467500;218556250000;262143;8677161;8939304;8152875;0.039255;quickSort
467600;218649760000;262143;8678961;8941104;8154675;0.038755;quickSort
467700;218743290000;262143;8680761;8942904;8156475;0.038379;quickSort
467800;218836840000;262143;8682561;8944704;8158275;0.038706;quickSort
467900;218930410000;262143;8684361;8946504;8160075;0.038640;quickSort
468000;219024000000;262143;8686161;8948304;8161875;0.038275;quickSort
468100;219117610000;262143;8687961;8950104;8163675;0.038860;quickSort
468200;219211240000;262143;8689761;8951904;8165475;0.038228;quickSort
468300;219304890000;262143;8691561;8953704;8167275;0.038304;quickSort
468400;219398560000;262143;8693361;8955504;8169075;0.038318;quickSort
468500;219492250000;262143;8695161;8957304;8170875;0.038985;quickSort
468600;219585960000;262143;8696961;8959104;8172675;0.038321;quickSort
468700;219679690000;262143;8698761;8960904;8174475;0.038896;quickSort
468800;219773440000;262143;8700561;8962704;8176275;0.038308;quickSort
468900;219867210000;262143;8702361;8964504;8178075;0.037633;quickSort
469000;219961000000;262143;8704161;8966304;8179875;0.037653;quickSort
469100;220054810000;262143;8705961;8968104;8181675;0.038346;quickSort
469200;220148640000;262143;8707761;8969904;8183475;0.039387;quickSort
469300;220242490000;262143;8709561;8971704;8185275;0.038554;quickSort
469400;220336360000;262143;8711361;8973504;8187075;0.039693;quickSort
469500;220430250000;262143;8713161;8975304;8188875;0.038654;quickSort
469600;220524160000;262143;8714961;8977104;8190675;0.038796;quickSort
469700;220618090000;262143;8716761;8978904;8192475;0.039297;quickSort
469800;220712040000;262143;8718561;8980704;8194275;0.038497;quickSort
469900;220806010000;262143;8720361;8982504;8196075;0.038572;quickSort
470000;220900000000;262143;8722161;8984304;8197875;0.038584;quickSort
470100;220994010000;262143;8723961;8986104;8199675;0.038443;quickSort
470200;221088040000;262143;8725761;8987904;8201475;0.038467;quickSort
470300;221182090000;262143;8727561;8989704;8203275;0.038759;quickSort
470400;221276160000;262143;8729361;8991504;8205075;0.038729;quickSort
470500;221370250000;262143;8731161;8993304;8206875;0.039423;quickSort
470600;221464360000;262143;8732961;8995104;8208675;0.038505;quickSort
470700;221558490000;262143;8734761;8996904;8210475;0.044576;quickSort
470800;221652640000;262143;8736561;8998704;8212275;0.038609;quickSort
470900;221746810000;262143;8738361;9000504;8214075;0.038572;quickSort
471000;221841000000;262143;8740161;9002304;8215875;0.039134;quickSort
471100;221935210000;262143;8741961;9004104;8217675;0.038474;quickSort
471200;222029440000;262143;8743761;9005904;8219475;0.038508;quickSort
471300;222123690000;262143;8745561;9007704;8221275;0.038567;quickSort
471400;222217960000;262143;8747361;9009504;8223075;0.038590;quickSort
471500;222312250000;262143;8749161;9011304;8224875;0.038517;quickSort
471600;222406560000;262143;8750961;9013104;8226675;0.038644;quickSort
471700;222500890000;262143;8752761;9014904;8228475;0.038578;quickSort
471800;222595240000;262143;8754561;9016704;8230275;0.038733;quickSort
471900;222689610000;262143;8756361;9018504;8232075;0.038739;quickSort
472000;222784000000;262143;8758161;9020304;8233875;0.038779;quickSort
472100;222878410000;262143;8759961;9022104;8235675;0.038706;quickSort
472200;222972840000;262143;8761761;9023904;8237475;0.039216;quickSort
472300;223067290000;262143;8763561;9025704;8239275;0.038844;quickSort
472400;223161760000;262143;8765361;9027504;8241075;0.039941;quickSort
472500;223256250000;262143;8767161;9029304;8242875;0.038582;quickSort
472600;223350760000;262143;8768961;9031104;8244675;0.038738;quickSort
472700;223445290000;262143;8770761;9032904;8246475;0.038720;quickSort
472800;223539840000;262143;8772561;9034704;8248275;0.038765;quickSort
472900;223634410000;262143;8774361;9036504;8250075;0.038737;quickSort
473000;223729000000;262143;8776161;9038304;8251875;0.039378;quickSort
473100;223823610000;262143;8777961;9040104;8253675;0.038734;quickSort
473200;223918240000;262143;8779761;9041904;8255475;0.038726;quickSort
473300;224012890000;262143;8781561;9043704;8257275;0.038749;quickSort
473400;224107560000;262143;8783361;9045504;8259075;0.038728;quickSort
473500;224202250000;262143;8785161;9047304;8260875;0.038472;quickSort
473600;224296960000;262143;8786961;9049104;8262675;0.039068;quickSort
473700;224391690000;262143;8788761;9050904;8264475;0.038763;quickSort
473800;224486440000;262143;8790561;9052704;8266275;0.038722;quickSort
473900;224581210000;262143;8792361;9054504;8268075;0.039986;quickSort
474000;224676000000;262143;8794161;9056304;8269875;0.040814;quickSort
474100;224770810000;262143;8795961;9058104;8271675;0.038766;quickSort
474200;224865640000;262143;8797761;9059904;8273475;0.038782;quickSort
474300;224960490000;262143;8799561;9061704;8275275;0.038885;quickSort
474400;225055360000;262143;8801361;9063504;8277075;0.039083;quickSort
474500;225150250000;262143;8803161;9065304;8278875;0.038834;quickSort
474600;225245160000;262143;8804961;9067104;8280675;0.038883;quickSort
474700;225340090000;262143;8806761;9068904;8282475;0.038800;quickSort
474800;225435040000;262143;8808561;9070704;8284275;0.041537;quickSort
474900;225530010000;262143;8810361;9072504;8286075;0.042297;quickSort
475000;225625000000;262143;8812161;9074304;8287875;0.038881;quickSort
